e_node_id,degree,in_degree,out_degree,clustering,pagerank
0,9,5,4,0.7777777777777778,0.0006932756841483206
1,40,27,13,0.17550143266475646,0.000816954763474023
2,10,7,3,0.0,0.00026051714878199707
3,56,35,21,0.26605504587155965,0.0021083008020725312
4,19,6,13,0.5718562874251497,0.0004232112169802619
5,25,13,12,0.4302721088435374,0.000730673881649979
6,58,38,20,0.0752442996742671,0.001088261652071228
7,16,6,10,0.4692982456140351,0.0003811054711227344
8,17,5,12,0.44656488549618323,0.00031714539145033207
9,14,5,9,0.6337209302325582,0.00031028664259095907
10,22,15,7,0.6684782608695652,0.00042770460818974043
11,8,3,5,0.4423076923076923,0.00013267189953918392
12,13,8,5,0.1509433962264151,0.0006782083123331768
13,6,0,6,0.2,6.45240993381665e-05
14,19,11,8,0.23053892215568864,0.0006771960010525718
15,14,4,10,0.46551724137931033,0.00011594175406742959
16,21,10,11,0.21568627450980393,0.00035628476103875535
17,11,3,8,0.2,0.00010916175175572411
18,2,0,2,1.0,6.45240993381665e-05
19,5,2,3,1.0,0.00026734265139587203
20,7,3,4,0.2,0.00029476658020396876
21,5,3,2,0.0,0.00016701141211653602
22,12,5,7,0.44047619047619047,0.00015529900121614434
23,21,15,6,0.05502392344497608,0.0005381003883755168
24,12,5,7,0.4418604651162791,0.0004914847127807775
25,7,2,5,0.1111111111111111,0.00016979146269633576
26,26,17,9,0.3,0.0014704419859295763
27,20,11,9,0.23648648648648649,0.0005891731502076837
28,9,3,6,0.4,0.00015092295208194383
29,5,0,5,0.35,6.45240993381665e-05
30,16,9,7,0.33707865168539325,0.0003266729697479122
31,71,48,23,0.1215113782739373,0.003609743826163856
32,27,22,5,0.09060402684563758,0.0009116378327902254
33,3,1,2,0.0,0.0001122234006173161
34,9,2,7,0.3088235294117647,0.00011706967875810598
35,2,0,2,1.0,6.45240993381665e-05
36,6,2,4,0.7307692307692307,0.00010827555444545224
37,6,3,3,0.5,0.00013128746121720218
38,1,0,1,0.0,6.45240993381665e-05
39,7,3,4,0.6111111111111112,0.00013895809680778548
40,3,0,3,0.16666666666666666,6.45240993381665e-05
41,15,5,10,0.1118421052631579,0.00024815945219842385
42,6,0,6,0.1,6.45240993381665e-05
43,105,85,20,0.033223201174743026,0.0029905684781445893
44,8,1,7,0.6333333333333333,7.344255600195866e-05
45,4,1,3,0.0,9.003564603751244e-05
46,21,7,14,0.30303030303030304,0.00023261025259006186
47,45,30,15,0.20123318385650224,0.0009397065067807546
48,12,5,7,0.5238095238095238,0.0002061690404030642
49,20,9,11,0.25,0.0003504313428671782
50,7,5,2,0.05,0.0003992739099435139
51,8,2,6,0.21428571428571427,0.00022355655074750936
52,31,23,8,0.1970074812967581,0.0020422858264000396
53,4,0,4,0.16666666666666666,6.45240993381665e-05
54,4,0,4,0.3333333333333333,6.45240993381665e-05
55,1,0,1,0.0,6.45240993381665e-05
56,8,3,5,0.38461538461538464,0.00011961958764385455
57,13,6,7,0.07407407407407407,0.00022776603597091617
58,18,10,8,0.10084033613445378,0.00038667879485944
59,3,0,3,0.3333333333333333,6.45240993381665e-05
60,7,3,4,0.5526315789473685,0.00019247142028228212
61,39,24,15,0.21232876712328766,0.0007828172615129731
62,4,0,4,0.4166666666666667,6.45240993381665e-05
63,41,30,11,0.06802721088435375,0.0012097707442284146
64,13,5,8,0.5540540540540541,0.00013702500571409482
65,2,0,2,1.0,6.45240993381665e-05
66,18,9,9,0.2966666666666667,0.0002881242692567788
67,7,4,3,0.7105263157894737,0.00019245707599901583
68,71,44,27,0.0775477060495331,0.0014715228303896315
69,65,55,10,0.07058521560574949,0.002899213899978479
70,17,9,8,0.5392156862745098,0.0012706167917085423
71,21,9,12,0.08771929824561403,0.00040256136719433
72,5,0,5,0.35,6.45240993381665e-05
73,21,5,16,0.24271844660194175,0.00017504969429525243
74,3,1,2,0.3333333333333333,7.409164262880253e-05
75,43,29,14,0.13534675615212527,0.0010760519206250028
76,16,7,9,0.25,0.0005294388497473136
77,14,9,5,0.15873015873015872,0.0010745059597544297
78,9,3,6,0.631578947368421,0.00023761423864806537
79,23,9,14,0.1796116504854369,0.0011153951565660305
80,11,2,9,0.027777777777777776,0.0001012973667340646
81,15,3,12,0.1118421052631579,0.00020457722801609288
82,7,2,5,0.9473684210526315,0.00019629377265806513
83,6,3,3,0.16666666666666666,0.00013654081270356175
84,13,6,7,0.88,0.00018621271994127746
85,20,13,7,0.16489361702127658,0.000471260997711032
86,2,1,1,0.0,0.00010909669470694671
87,4,1,3,0.08333333333333333,7.874188179726269e-05
88,34,22,12,0.044444444444444446,0.0006694249420943659
89,41,27,14,0.11716621253405994,0.0020957257841714167
90,36,29,7,0.09874326750448834,0.002098607447403514
91,17,8,9,0.8775510204081632,0.0004005614183959949
92,17,6,11,0.35877862595419846,0.00017913506371126822
93,10,2,8,0.23214285714285715,9.26514925682195e-05
94,3,0,3,0.16666666666666666,6.45240993381665e-05
95,12,3,9,0.08888888888888889,0.00013519104227582645
96,6,1,5,0.17857142857142858,0.00019166347697754607
97,6,3,3,0.16666666666666666,0.0001982348434286331
98,4,1,3,0.8,0.0001109216319869509
99,16,7,9,0.0811965811965812,0.0003824093430715553
100,20,6,14,0.2733333333333333,0.00029870065600157906
101,22,8,14,0.23783783783783785,0.0003969683966565366
102,5,2,3,0.3333333333333333,0.00017770605825034055
103,9,3,6,0.225,0.00010763310838842396
104,19,9,10,0.37786259541984735,0.0002283041740152097
105,2,1,1,0.0,0.0004291135815339865
106,14,3,11,0.1853932584269663,0.00013353569127581703
107,30,21,9,0.15775401069518716,0.0020170307338759534
108,10,1,9,0.5681818181818182,0.00023897180696990473
109,18,8,10,0.8008849557522124,0.0004005614183959949
110,22,8,14,0.41294642857142855,0.0003931924118818146
111,6,2,4,0.3,9.471691668046876e-05
112,6,2,4,0.9166666666666666,0.00015476338775258794
113,18,7,11,0.30405405405405406,0.00024821197990806287
114,13,5,8,0.4326923076923077,0.0001552990012161443
115,4,1,3,0.0,0.00015726280578995397
116,13,9,4,0.21818181818181817,0.00029355745391990807
117,17,14,3,0.24253731343283583,0.0005957072589174307
118,6,2,4,0.4642857142857143,0.00010269982090236495
119,43,21,22,0.11689038031319911,0.0015326248587053148
120,11,2,9,0.3142857142857143,0.000126581742712082
121,8,2,6,0.35185185185185186,0.00013980654192822015
122,4,1,3,0.4,0.0001109216319869509
123,7,5,2,0.2,0.0005151131638947498
124,48,32,16,0.14961013645224172,0.001953732429073528
125,14,7,7,0.7049180327868853,0.0004399291886051077
126,3,2,1,0.0,0.0005884573511930449
127,5,1,4,0.5,8.193652845627633e-05
128,15,7,8,0.6027397260273972,0.0003711409363171334
129,11,5,6,0.07407407407407407,0.00019238853622974796
130,2,1,1,0.0,0.0004291135815339865
131,3,2,1,0.0,0.0004926905425434396
132,5,0,5,0.2,6.45240993381665e-05
133,17,9,8,0.3217821782178218,0.00035946311357911375
134,1,0,1,0.0,6.45240993381665e-05
135,7,3,4,0.34210526315789475,0.000135607871533892
136,24,15,9,0.06986899563318777,0.0008578634782244414
137,6,1,5,0.6428571428571429,0.000254906488098527
138,3,1,2,0.0,0.0001122234006173161
139,12,6,6,0.21875,0.0007881756108816195
140,15,11,4,0.05263157894736842,0.0009555830923108106
141,10,2,8,0.4883720930232558,0.00018710057036289558
142,10,3,7,0.45348837209302323,0.0003655832768234096
143,5,1,4,0.5,0.0001109216319869509
144,4,1,3,0.08333333333333333,9.601461166419945e-05
145,9,3,6,0.3157894736842105,0.00019359605466564938
146,48,26,22,0.1432408236347359,0.0009835818383200068
147,14,5,9,0.6918604651162791,0.00012291889757742888
148,11,2,9,0.14814814814814814,9.061136040586627e-05
149,7,1,6,0.15,7.517432005016391e-05
150,5,2,3,0.16666666666666666,0.00010916930606202189
151,13,5,8,0.7671232876712328,0.00012160696333410808
152,1,0,1,0.0,6.45240993381665e-05
153,15,7,8,0.6575342465753424,0.00022322764634776328
154,7,4,3,0.5,0.0005978142011934288
155,16,8,8,0.4482758620689655,0.0008960840442599438
156,4,0,4,0.16666666666666666,6.45240993381665e-05
157,7,3,4,0.5,0.0005559729300763906
158,3,0,3,0.0,6.45240993381665e-05
159,20,10,10,0.613013698630137,0.0005319617488830199
160,30,17,13,0.13672922252010725,0.0007710613337277335
161,13,6,7,0.88,0.00018621271994127744
162,8,2,6,0.5,0.00020557198856056158
163,8,0,8,0.19642857142857142,6.45240993381665e-05
164,10,3,7,0.2037037037037037,0.0001147130146344917
165,13,5,8,0.7671232876712328,0.00012160696333410808
166,6,1,5,0.23333333333333334,8.864223736438284e-05
167,15,7,8,0.400990099009901,0.00027142970811055306
168,4,2,2,0.5,0.0001152306392093103
169,2,1,1,0.0,0.00011256605231831595
170,10,2,8,0.1111111111111111,9.471691668046876e-05
171,17,6,11,0.61,0.00013452982568294924
172,12,4,8,0.5080645161290323,0.00012860954483817606
173,9,5,4,0.5,0.0003641430668282376
174,8,3,5,0.16666666666666666,0.00012468841882812582
175,9,2,7,0.5588235294117647,0.00012023282238799953
176,12,5,7,0.13636363636363635,0.0003162307324211948
177,12,3,9,0.2777777777777778,0.0006630690168375499
178,10,1,9,0.2857142857142857,7.125395797641472e-05
179,15,9,6,0.35294117647058826,0.0002762118328640643
180,15,7,8,0.30666666666666664,0.0001818523235746622
181,29,15,14,0.19924812030075187,0.00042418104051909663
182,14,5,9,0.6918604651162791,0.00012291889757742888
183,14,5,9,0.29310344827586204,0.0002005863382792818
184,3,0,3,0.3333333333333333,6.45240993381665e-05
185,39,27,12,0.15940054495912806,0.0024645762506432345
186,15,6,9,0.29207920792079206,0.00028292733414045455
187,6,2,4,0.4,0.00011666462330335781
188,15,5,10,0.61,0.00012398900561647803
189,8,3,5,0.25,0.00014764010410799668
190,3,1,2,0.0,8.280671854356432e-05
191,2,1,1,0.0,0.0004291135815339865
192,1,0,1,0.0,6.45240993381665e-05
193,4,1,3,0.0,9.003564603751244e-05
194,5,2,3,0.1111111111111111,0.0001911100232076982
195,6,2,4,0.8461538461538461,0.00029139942107626643
196,21,11,10,0.2874251497005988,0.0012482618470267834
197,2,1,1,0.0,0.0004291135815339865
198,1,0,1,0.0,6.45240993381665e-05
199,5,1,4,0.0,8.193652845627633e-05
200,6,3,3,0.0,0.00031005511446042085
201,7,1,6,0.1,7.517432005016391e-05
202,3,0,3,1.0,6.45240993381665e-05
203,4,2,2,0.0,0.00012812316771036597
204,4,0,4,0.16666666666666666,6.45240993381665e-05
205,6,4,2,0.2,0.0007407601100174459
206,8,1,7,0.7666666666666667,7.344255600195866e-05
207,4,2,2,0.25,0.00010966332080942035
208,2,1,1,1.0,9.148659858659545e-05
209,3,1,2,0.0,9.255408279380963e-05
210,9,2,7,0.125,0.00011904687494946115
211,3,1,2,0.0,0.0001122234006173161
212,2,1,1,0.0,0.0004291135815339865
213,14,5,9,0.375,0.0003988622688298298
214,1,0,1,0.0,6.45240993381665e-05
215,8,2,6,0.16666666666666666,0.00015491435140473246
216,28,13,15,0.303125,0.0008941745602528613
217,13,3,10,0.21333333333333335,0.00015670526918666486
218,12,7,5,0.046153846153846156,0.00021670824277787034
219,6,0,6,0.26666666666666666,6.45240993381665e-05
220,16,10,6,0.211864406779661,0.0004593316089321437
221,37,28,9,0.20106221547799696,0.002340607801815872
222,20,14,6,0.2986577181208054,0.0009950265224681284
223,16,7,9,0.5689655172413793,0.0008310985497974469
224,36,16,20,0.8424908424908425,0.0008920354123853664
225,39,17,22,0.7135176651305684,0.0009769636862004562
226,78,53,25,0.2915194346289753,0.002303786877255109
227,17,14,3,0.4519230769230769,0.0010007616187777458
228,108,78,30,0.18101425735426818,0.003599641947741588
229,43,20,23,0.5879052369077307,0.0010217456344192883
230,6,0,6,0.36666666666666664,6.45240993381665e-05
231,18,5,13,0.34051724137931033,0.0005981886916219119
232,36,16,20,0.8223443223443223,0.0008920354123853664
233,43,21,22,0.6245330012453301,0.0010724032823178546
234,19,5,14,0.48502994011976047,0.0004838598303391408
235,118,80,38,0.15336545700948653,0.0040877509516415835
236,48,24,24,0.47544204322200395,0.0012521429394284577
237,24,14,10,0.13274336283185842,0.0008664572413828455
238,7,2,5,0.45,0.00014382361119498227
239,15,7,8,0.2866666666666667,0.0002590569412770368
240,6,2,4,0.14285714285714285,0.00013848424724385806
241,38,16,22,0.767479674796748,0.0008920354123853664
242,54,26,28,0.4029793735676089,0.001248254036694244
243,34,17,17,0.9293139293139293,0.0009867403117657465
244,56,33,23,0.3772116065109696,0.0016113957637704077
245,46,21,25,0.5708915145005371,0.0010878858212121413
246,37,16,21,0.8017241379310345,0.0008920354123853664
247,59,35,24,0.32552248258391386,0.0019282764431966545
248,4,1,3,0.0,9.003564603751244e-05
249,6,2,4,0.3,0.00011866062213878108
250,9,4,5,0.2631578947368421,0.00029288425771926984
251,3,1,2,0.0,9.344259309550452e-05
252,17,11,6,0.049019607843137254,0.0006488395026702042
253,4,2,2,1.0,0.00026395143849517296
254,42,38,4,0.043701799485861184,0.0021789583414420243
255,6,3,3,0.0,0.00025462507562996623
256,5,1,4,0.0,8.193652845627633e-05
257,7,3,4,0.1111111111111111,0.0001360730512568909
258,3,1,2,0.0,0.0001122234006173161
259,6,3,3,1.0,0.0003765914967629139
260,4,1,3,0.0,9.003564603751244e-05
261,6,2,4,0.6,0.00014915464748310183
262,2,0,2,0.0,6.45240993381665e-05
263,3,1,2,0.0,0.0001122234006173161
264,6,1,5,0.08333333333333333,7.77406846476358e-05
265,1,1,0,0.0,8.376242256849277e-05
266,14,6,8,0.3253968253968254,0.0009559014493935349
267,2,0,2,1.0,6.45240993381665e-05
268,10,0,10,0.5666666666666667,6.45240993381665e-05
269,21,14,7,0.6305418719211823,0.0003812598169733261
270,18,4,14,0.5897435897435898,0.00010051380346816924
271,16,4,12,0.625,0.0001225897171899544
272,26,15,11,0.419811320754717,0.000416452904161244
273,2,1,1,0.0,0.0004291135815339865
274,1,0,1,0.0,6.45240993381665e-05
275,7,3,4,0.3,0.00012172405840174254
276,6,1,5,0.08333333333333333,7.77406846476358e-05
277,40,37,3,0.10327635327635327,0.008060116617547191
278,12,5,7,0.6557377049180327,0.00015472913243833841
279,10,4,6,0.48,0.0001585028842887786
280,16,11,5,0.06666666666666667,0.0008432849663600631
281,3,0,3,0.0,6.45240993381665e-05
282,2,1,1,0.0,0.0004291135815339865
283,11,6,5,0.22641509433962265,0.0002137651915407794
284,16,6,10,0.45555555555555555,0.00015781394411642024
285,17,5,12,0.44402985074626866,0.0001410440062321285
286,1,0,1,0.0,6.45240993381665e-05
287,3,1,2,0.0,0.0001122234006173161
288,24,15,9,0.5892857142857143,0.00042770460818974043
289,29,14,15,0.5794117647058824,0.00040374873147192697
290,18,16,2,0.29583333333333334,0.0016048447271375006
291,10,5,5,1.0,0.00014830027554205993
292,12,7,5,0.25,0.001128171905696471
293,3,1,2,0.3333333333333333,6.726649221897618e-05
294,5,0,5,0.25,6.45240993381665e-05
295,7,2,5,0.2777777777777778,0.0001584816652739448
296,2,0,2,1.0,6.45240993381665e-05
297,4,0,4,0.16666666666666666,6.45240993381665e-05
298,8,2,6,0.07142857142857142,9.446329446537935e-05
299,8,4,4,0.3148148148148148,0.0002137113193517525
300,6,2,4,0.25,0.00010343735067583953
301,5,1,4,0.0,8.193652845627633e-05
302,2,1,1,0.0,0.0004291135815339865
303,2,1,1,0.0,0.00012006853755466417
304,38,22,16,0.23070739549839228,0.0007713124933550739
305,11,1,10,0.5092592592592593,0.00011096889055458087
306,2,1,1,0.0,0.0001122234006173161
307,15,7,8,0.6301369863013698,0.0006138689900759382
308,11,4,7,0.17142857142857143,0.0001753895266522096
309,4,1,3,0.5,9.003564603751244e-05
310,21,8,13,0.19940476190476192,0.0005336724451161509
311,2,0,2,1.0,6.45240993381665e-05
312,2,1,1,0.0,0.0004291135815339865
313,1,0,1,0.0,6.45240993381665e-05
314,2,0,2,0.0,6.45240993381665e-05
315,6,3,3,0.0,0.0004250328476780284
316,5,1,4,0.0,8.193652845627633e-05
317,5,1,4,0.1111111111111111,7.790717307163624e-05
318,11,3,8,0.2,0.0001263742855912359
319,10,2,8,0.1744186046511628,0.00011355837318749284
320,6,2,4,0.0,0.00017847074255834724
321,6,2,4,0.2,0.00012800724370289952
322,18,11,7,0.0782608695652174,0.0005353964295635625
323,23,13,10,0.10344827586206896,0.0007305255420986167
324,3,2,1,0.0,0.0006033645101182443
325,16,8,8,0.07954545454545454,0.0007472525614843425
326,8,3,5,0.3076923076923077,0.00024381502742119702
327,11,5,6,0.36792452830188677,0.0001840455860208205
328,4,0,4,1.0,6.45240993381665e-05
329,5,2,3,0.5,0.00012800724370289952
330,7,2,5,0.2222222222222222,0.00018011691910194561
331,3,3,0,0.16666666666666666,0.00011526507350053555
332,5,1,4,0.2222222222222222,0.00017327713278587472
333,12,6,6,0.4444444444444444,0.00022976199923846347
334,23,15,8,0.1024390243902439,0.000797977829845783
335,9,2,7,0.1,0.0001442419036306352
336,5,0,5,0.9,6.45240993381665e-05
337,2,0,2,0.0,6.45240993381665e-05
338,8,3,5,0.21428571428571427,0.00014202418670554158
339,9,2,7,0.1,0.0005260616797542408
340,14,7,7,0.2619047619047619,0.000525280264867837
341,26,13,13,0.651685393258427,0.00038836200328621636
342,4,2,2,1.0,0.00017107041401290008
343,6,2,4,0.16666666666666666,0.00011676138669249599
344,33,26,7,0.04772234273318872,0.001623657848074037
345,6,0,6,0.43333333333333335,6.45240993381665e-05
346,24,18,6,0.11013215859030837,0.0008589188472487995
347,4,2,2,0.0,0.0001710739189539537
348,18,14,4,0.0635593220338983,0.0013415502704285757
349,1,0,1,0.0,6.45240993381665e-05
350,2,1,1,0.0,0.0004291135815339865
351,5,1,4,0.0,0.00013799595101055586
352,7,2,5,0.2777777777777778,0.00010591601224805218
353,7,3,4,0.375,0.00024837865677887965
354,13,5,8,0.5753424657534246,0.00015685407480199159
355,6,5,1,0.0,0.0008846549294327924
356,5,0,5,0.1,6.45240993381665e-05
357,15,5,10,0.49333333333333335,0.00022712208550798617
358,15,5,10,0.52,0.0002271220855079862
359,11,4,7,0.3333333333333333,0.00028513497555133463
360,17,1,16,0.17777777777777778,0.002353308599812807
361,4,0,4,0.16666666666666666,6.45240993381665e-05
362,3,2,1,0.3333333333333333,0.00015916085217027772
363,6,1,5,0.5,7.77406846476358e-05
364,7,6,1,0.1,0.0004577459819392808
365,5,3,2,0.4,0.00020457722801609288
366,14,5,9,0.5232558139534884,0.00015854761194013646
367,3,2,1,1.0,0.00018537321244599476
368,4,1,3,1.0,9.003564603751244e-05
369,3,0,3,0.0,6.45240993381665e-05
370,10,5,5,0.76,0.0002271220855079862
371,3,1,2,0.0,0.0001122234006173161
372,10,7,3,0.017857142857142856,0.0005831212160973579
373,20,9,11,0.47278911564625853,0.0008204373297113053
374,5,2,3,0.16666666666666666,0.00015601187999497176
375,28,18,10,0.1974921630094044,0.0008461411512779642
376,2,0,2,0.0,6.45240993381665e-05
377,5,0,5,0.1,6.45240993381665e-05
378,11,3,8,0.20588235294117646,0.00011109069095262252
379,3,0,3,0.16666666666666666,6.45240993381665e-05
380,4,1,3,0.0,9.003564603751244e-05
381,6,2,4,0.2,0.0002907657117153509
382,3,0,3,0.0,6.45240993381665e-05
383,12,5,7,0.21428571428571427,0.00019312431632744745
384,12,3,9,0.19047619047619047,0.0001200818514911469
385,5,0,5,0.3,6.45240993381665e-05
386,27,11,16,0.23469387755102042,0.0006083066320004332
387,10,1,9,0.18181818181818182,0.00014405393499364625
388,22,13,9,0.6636771300448431,0.0004929911297101837
389,1,0,1,0.0,6.45240993381665e-05
390,6,0,6,0.26666666666666666,6.45240993381665e-05
391,72,54,18,0.08000831255195345,0.0028783335420070914
392,27,16,11,0.5309278350515464,0.0006131622366081947
393,281,258,23,0.01626509132184501,0.012240367903072286
394,6,3,3,0.36666666666666664,0.00010655323373282558
395,10,3,7,0.17857142857142858,0.0001578172840390627
396,48,25,23,0.21939275220372184,0.001794768607440197
397,54,35,19,0.09977151561309977,0.005602440952321959
398,14,0,14,0.12637362637362637,6.45240993381665e-05
399,52,38,14,0.08874281018898932,0.0034339810521700205
400,100,86,14,0.03847775669407548,0.0073460962572636035
401,22,10,12,0.1164021164021164,0.0004552291218635782
402,6,2,4,0.4,0.00014383526337805069
403,15,5,10,0.53,0.00014540320715744637
404,2,0,2,1.0,6.45240993381665e-05
405,52,52,0,0.03657616892911011,0.00239490655724402
406,13,4,9,0.2222222222222222,0.00021498176099462
407,4,1,3,0.4,0.00015574724952623802
408,23,15,8,0.6078431372549019,0.00042770460818974054
409,25,11,14,0.375,0.00032048272082601566
410,23,13,10,0.28830645161290325,0.002766502701154513
411,35,30,5,0.0583756345177665,0.0015595251843685694
412,3,0,3,0.16666666666666666,6.45240993381665e-05
413,10,5,5,0.07954545454545454,0.0003309031627833262
414,5,0,5,0.5,6.45240993381665e-05
415,14,5,9,0.4827586206896552,0.0001822936281427113
416,19,11,8,0.25149700598802394,0.0016607173181186696
417,13,3,10,0.7368421052631579,0.00016510259749889672
418,23,11,12,0.573469387755102,0.0004642934391799076
419,42,23,19,0.2282184655396619,0.001634844317129828
420,16,5,11,0.5217391304347826,0.0001464467535103299
421,1,0,1,0.0,6.45240993381665e-05
422,9,3,6,0.5454545454545454,0.00018840659358599878
423,14,7,7,0.5245901639344263,0.00026399164580469904
424,9,4,5,0.8888888888888888,0.00017163972267376034
425,34,18,16,0.23721881390593047,0.001553914043510256
426,18,6,12,0.42567567567567566,0.00016440105422124902
427,29,19,10,0.07902298850574713,0.0006831206234056377
428,6,2,4,0.25,8.189742010600873e-05
429,11,2,9,0.2714285714285714,9.928045209135045e-05
430,17,8,9,0.3284313725490196,0.0003923253784062745
431,1,0,1,0.0,6.45240993381665e-05
432,24,10,14,0.39325842696629215,0.00029133634080862595
433,52,31,21,0.16694146743610883,0.0021113791916977523
434,36,23,13,0.19077757685352623,0.0020428247496713423
435,30,15,15,0.28610354223433243,0.00189542223205473
436,23,16,7,0.06067961165048544,0.0006683260969617363
437,12,7,5,0.07954545454545454,0.00032220450265777834
438,2,0,2,0.0,6.45240993381665e-05
439,2,0,2,0.0,6.45240993381665e-05
440,32,15,17,0.33886255924170616,0.0003654659386954776
441,10,4,6,0.40476190476190477,0.0001822514745550865
442,6,2,4,0.2857142857142857,0.00011601964175116352
443,7,0,7,0.30952380952380953,6.45240993381665e-05
444,12,6,6,0.5403225806451613,0.0004689232194126756
445,236,215,21,0.011963302752293578,0.012731036601331786
446,14,5,9,0.5116279069767442,0.00015854761194013643
447,4,2,2,0.0,0.00014251027277835588
448,25,14,11,0.4590443686006826,0.00039693240167665126
449,25,12,13,0.3848797250859107,0.00039990106943623663
450,2,0,2,0.5,6.45240993381665e-05
451,43,23,20,0.25650557620817843,0.0009500913114450497
452,1,0,1,0.0,6.45240993381665e-05
453,1,0,1,0.0,6.45240993381665e-05
454,11,0,11,0.5272727272727272,6.45240993381665e-05
455,3,0,3,0.3333333333333333,6.45240993381665e-05
456,2,0,2,0.0,6.45240993381665e-05
457,35,20,15,0.19171483622350674,0.0016942209735454471
458,67,63,4,0.038517091959557055,0.00923933324064827
459,9,5,4,0.07142857142857142,0.00021422773839087627
460,10,2,8,0.22727272727272727,8.976362055227356e-05
461,50,32,18,0.2459605026929982,0.0015551674457746141
462,9,1,8,0.21428571428571427,7.219520658272641e-05
463,9,0,9,0.1111111111111111,6.45240993381665e-05
464,55,34,21,0.1441196464989803,0.0026813871343454765
465,7,4,3,0.6111111111111112,0.0005664003315017053
466,5,3,2,0.125,0.0003171300379124117
467,19,6,13,0.3825301204819277,0.0001652422827451217
468,1,1,0,0.0,9.070668592763809e-05
469,7,2,5,0.1111111111111111,0.0001604345393385822
470,6,1,5,0.0,7.77406846476358e-05
471,87,61,26,0.07685810810810811,0.0027510948073165386
472,18,10,8,0.4664429530201342,0.0005731804389171114
473,7,4,3,0.0,0.00024188890735502624
474,2,0,2,0.0,6.45240993381665e-05
475,39,24,15,0.20861833105335156,0.0019254864825707647
476,61,43,18,0.05229142185663925,0.002185787958498866
477,21,8,13,0.19879518072289157,0.0002923730649944812
478,1,0,1,0.0,6.45240993381665e-05
479,5,2,3,0.05,0.00033405534788271606
480,9,2,7,0.09722222222222222,0.00012963582973542592
481,11,5,6,0.2169811320754717,0.0003294456480359438
482,9,2,7,0.1,0.002072759192272002
483,22,14,8,0.39473684210526316,0.0008150102365543071
484,10,3,7,0.5961538461538461,0.0002730511113754552
485,19,10,9,0.2840909090909091,0.0016925962077075356
486,5,0,5,0.1,6.45240993381665e-05
487,3,0,3,0.3333333333333333,6.45240993381665e-05
488,6,3,3,0.0,0.0004947926727573476
489,273,251,22,0.009843865357797162,0.01027172617883609
490,7,3,4,0.7105263157894737,0.0001585580327083729
491,4,1,3,0.1,9.003564603751244e-05
492,3,0,3,0.0,6.45240993381665e-05
493,43,33,10,0.044063647490820076,0.0014910188976034193
494,29,16,13,0.44823232323232326,0.0006989815927854745
495,6,1,5,0.16666666666666666,7.77406846476358e-05
496,55,51,4,0.017805232558139535,0.004574609450955199
497,20,7,13,0.10596026490066225,0.00030101778935896366
498,6,2,4,0.2857142857142857,0.0001545674160398959
499,5,2,3,0.375,0.00014602750357278315
500,2,1,1,0.0,9.887410022419341e-05
501,11,6,5,0.8,0.00015827357519415626
502,8,0,8,0.2857142857142857,6.45240993381665e-05
503,4,0,4,0.08333333333333333,6.45240993381665e-05
504,13,0,13,0.4935897435897436,6.45240993381665e-05
505,23,10,13,0.5102880658436214,0.0003210777203078232
506,2,0,2,0.5,6.45240993381665e-05
507,5,2,3,0.3333333333333333,9.942649006806129e-05
508,13,0,13,0.532051282051282,6.45240993381665e-05
509,87,70,17,0.060303626651672756,0.003561102968794377
510,60,41,19,0.09675583380762663,0.00269099326333294
511,4,1,3,1.0,0.00017216532460169722
512,27,14,13,0.5584192439862543,0.0005819340613568263
513,9,6,3,0.17142857142857143,0.00020672614790025884
514,12,2,10,0.1640625,0.00012770784273005272
515,37,25,12,0.0730050933786078,0.000883627136529943
516,10,4,6,0.07692307692307693,0.00024229281863057716
517,5,0,5,0.05,6.45240993381665e-05
518,29,14,15,0.4105793450881612,0.0005425644583080966
519,2,0,2,1.0,6.45240993381665e-05
520,3,0,3,0.5,6.45240993381665e-05
521,24,13,11,0.5674157303370787,0.0004901359173013918
522,4,2,2,0.5,9.87178255019408e-05
523,14,0,14,0.35714285714285715,6.45240993381665e-05
524,2,0,2,0.0,6.45240993381665e-05
525,94,77,17,0.0429940119760479,0.005249851203171206
526,110,98,12,0.019050917907862834,0.004478387776067571
527,11,1,10,0.09259259259259259,0.000112534724429738
528,17,0,17,0.27205882352941174,6.45240993381665e-05
529,3,0,3,0.16666666666666666,6.45240993381665e-05
530,6,3,3,0.3076923076923077,0.00017196848264295194
531,27,17,10,0.2423728813559322,0.0010732825822164223
532,3,0,3,0.6666666666666666,6.45240993381665e-05
533,6,2,4,0.07142857142857142,0.00023323381869142412
534,14,6,8,0.5465116279069767,0.00018966457557829675
535,3,0,3,0.16666666666666666,6.45240993381665e-05
536,48,25,23,0.15964740450538686,0.0006855627058035017
537,7,0,7,0.2619047619047619,6.45240993381665e-05
538,28,13,15,0.3446866485013624,0.00047322448086193063
539,4,0,4,0.08333333333333333,6.45240993381665e-05
540,26,13,13,0.41198501872659177,0.00032761982586105063
541,21,12,9,0.5828220858895705,0.0005401655701475364
542,12,7,5,0.4186046511627907,0.00041620118628235884
543,2,0,2,1.0,6.45240993381665e-05
544,20,9,11,0.16304347826086957,0.00040497591738610243
545,9,5,4,0.425,0.00020833396037612975
546,18,11,7,0.23504273504273504,0.00031502782426430303
547,12,5,7,0.3068181818181818,0.0001707753256284066
548,9,4,5,0.34210526315789475,0.00019126912837997547
549,8,3,5,0.38461538461538464,0.00014759654863400745
550,4,0,4,0.3333333333333333,6.45240993381665e-05
551,4,1,3,1.0,9.003564603751244e-05
552,23,10,13,0.39800995024875624,0.00042223263453128643
553,35,19,16,0.312984496124031,0.0005240937626633882
554,15,10,5,0.4144736842105263,0.0003738826255725195
555,45,28,17,0.26182432432432434,0.0009475046067776447
556,18,8,10,0.7831858407079646,0.0003315109876563
557,19,7,12,0.35384615384615387,0.0002572919925229379
558,24,13,11,0.41294642857142855,0.0005740518421525119
559,34,14,20,0.2793814432989691,0.00035570341073840685
560,13,6,7,0.17647058823529413,0.0002571454064176409
561,22,9,13,0.25268817204301075,0.00037918287130309206
562,13,5,8,0.5490196078431373,0.0003969218953696404
563,4,0,4,0.5,6.45240993381665e-05
564,11,4,7,0.5294117647058824,0.0001480960200218721
565,6,0,6,0.6,6.45240993381665e-05
566,11,4,7,0.5294117647058824,0.0001480960200218721
567,2,0,2,0.5,6.45240993381665e-05
568,48,44,4,0.12622222222222224,0.0019432957758208271
569,58,51,7,0.10855063674954518,0.002213439789934618
570,11,4,7,0.3787878787878788,0.0001489012924991452
571,9,2,7,0.3,9.08632916363115e-05
572,6,2,4,0.1,0.00010444757554884525
573,9,5,4,0.3157894736842105,0.00014811902045768882
574,4,1,3,0.0,9.003564603751244e-05
575,14,5,9,0.31451612903225806,0.00016190565814903815
576,2,1,1,0.0,0.0004291135815339865
577,5,1,4,0.3333333333333333,9.055798319011996e-05
578,16,8,8,0.7787610619469026,0.0002523811087115364
579,10,4,6,0.8292682926829268,0.00018874774249303848
580,10,2,8,0.2727272727272727,0.00010209539607062004
581,43,20,23,0.378428927680798,0.0005444865958399505
582,33,16,17,0.5555555555555556,0.0005325457091609711
583,18,7,11,0.7017543859649122,0.00030900289105221905
584,14,6,8,0.8588235294117647,0.000279241717242445
585,7,1,6,0.45,7.53822235646793e-05
586,18,8,10,0.678082191780822,0.0002532153290772558
587,4,0,4,0.5833333333333334,6.45240993381665e-05
588,31,14,17,0.565410199556541,0.000438904177572108
589,30,13,17,0.4516509433962264,0.00041728648753857787
590,21,10,11,0.74,0.00033584102949223984
591,13,5,8,0.547945205479452,0.00028320158984981354
592,21,9,12,0.45544554455445546,0.00042722481660210877
593,26,12,14,0.44089456869009586,0.0005387403492873396
594,6,1,5,0.39285714285714285,8.545510294101795e-05
595,16,8,8,0.7610619469026548,0.00031272176604877185
596,45,23,22,0.3634020618556701,0.0009908671172485744
597,4,1,3,0.6,8.963065573961505e-05
598,13,5,8,0.5205479452054794,0.00023102635568271988
599,8,3,5,0.86,0.0002502504610670656
600,18,7,11,0.589041095890411,0.00027518403603290126
601,32,14,18,0.5373443983402489,0.0004400720247106747
602,78,48,30,0.1320254506892895,0.0017709413947870677
603,22,10,12,0.5292792792792793,0.00045200039847559316
604,12,4,8,0.75,0.00017391827683137798
605,13,4,9,0.5337837837837838,0.00016417113970219776
606,16,7,9,0.668141592920354,0.0002708575570022619
607,18,6,12,0.35714285714285715,0.00027150786298006717
608,34,17,17,0.47527472527472525,0.0006113821470226686
609,17,7,10,0.7364341085271318,0.000305462275455173
610,6,2,4,0.6538461538461539,0.00012249841522477028
611,18,7,11,0.6815068493150684,0.00030765983661972424
612,1,0,1,0.0,6.45240993381665e-05
613,9,1,8,0.6142857142857143,8.471099004949174e-05
614,4,0,4,0.5,6.45240993381665e-05
615,11,2,9,0.39090909090909093,0.00010291759966950194
616,5,0,5,0.5,6.45240993381665e-05
617,10,4,6,0.5769230769230769,0.00018027029431836043
618,8,1,7,0.4666666666666667,7.344255600195866e-05
619,10,4,6,0.047619047619047616,0.00026672766470810607
620,7,1,6,0.525,9.56486339508641e-05
621,13,5,8,0.6917808219178082,0.00014729504982337219
622,22,18,4,0.09388646288209607,0.0008929901929900925
623,35,30,5,0.10321489001692047,0.0020653854520572956
624,114,89,25,0.07480632666236281,0.003921066503959679
625,17,8,9,0.765625,0.00032619925465165344
626,14,5,9,0.6337209302325582,0.00014888607197965215
627,7,1,6,0.475,8.279419488528656e-05
628,32,13,19,0.4161490683229814,0.0004888645778950016
629,6,2,4,0.6153846153846154,0.0001181180151976866
630,13,5,8,0.6917808219178082,0.00014729504982337219
631,19,7,12,0.625,0.00024659880314772514
632,4,0,4,0.9166666666666666,6.45240993381665e-05
633,5,2,3,0.75,0.00011159286235380249
634,11,4,7,0.6274509803921569,0.0001602155931321991
635,3,1,2,0.5,9.414521699312006e-05
636,1,0,1,0.0,6.45240993381665e-05
637,12,5,7,0.7786885245901639,0.00014529875312215297
638,10,4,6,0.7804878048780488,0.00015737183191802794
639,17,8,9,0.7441860465116279,0.00025771969312300664
640,4,1,3,0.6,9.51916095739268e-05
641,6,1,5,0.39285714285714285,0.00010286800775006623
642,4,1,3,0.4,0.00010453824459903626
643,3,1,2,1.0,0.00019818194949804293
644,6,2,4,0.38461538461538464,0.00021702799408500106
645,15,7,8,0.6020408163265306,0.0003633568207454647
646,6,1,5,0.5,0.00011073826710958994
647,11,4,7,0.5454545454545454,0.0002849320597960913
648,36,14,22,0.1856,0.0016133267379048306
649,3,1,2,0.0,0.0001122234006173161
650,4,1,3,0.2,0.0001395720889086649
651,12,5,7,0.4166666666666667,0.000273901597640589
652,2,0,2,1.0,6.45240993381665e-05
653,8,2,6,0.16666666666666666,9.632680731882877e-05
654,9,6,3,0.25,0.0006392354324026566
655,5,2,3,0.0,0.00010785954221782942
656,1,0,1,0.0,6.45240993381665e-05
657,11,4,7,0.13636363636363635,0.00036483896390645946
658,9,3,6,0.6578947368421053,0.0004522610399175678
659,9,7,2,0.0,0.0005211282687286801
660,6,2,4,0.8,0.0002512026128163802
661,3,2,1,1.0,0.00015219519205434502
662,7,4,3,0.05,0.00024082937770003975
663,20,9,11,0.2,0.0011074708405663348
664,3,0,3,0.3333333333333333,6.45240993381665e-05
665,9,0,9,0.25,6.45240993381665e-05
666,23,15,8,0.06220095693779904,0.0007075059075633079
667,24,10,14,0.1288888888888889,0.00045778827726752783
668,22,15,7,0.1211453744493392,0.0015032755792176518
669,6,3,3,0.0,0.0001918757319440718
670,23,11,12,0.10049019607843138,0.001176289987091083
671,2,1,1,0.0,0.0004291135815339865
672,10,3,7,0.2840909090909091,0.0002517205173677015
673,14,9,5,0.11931818181818182,0.0006034931431276723
674,1,0,1,0.0,6.45240993381665e-05
675,1,0,1,0.0,6.45240993381665e-05
676,12,4,8,0.2265625,0.000408472577135223
677,2,0,2,0.5,6.45240993381665e-05
678,8,3,5,0.14285714285714285,0.00025322965674808327
679,9,5,4,0.10526315789473684,0.0004659243106892799
680,18,9,9,0.21739130434782608,0.0005353715980896733
681,2,1,1,0.0,0.00014784471967818678
682,64,59,5,0.01798941798941799,0.003400221412890227
683,4,1,3,0.4,0.00016369262365108735
684,4,1,3,0.0,0.00011134519771139975
685,4,0,4,0.0,6.45240993381665e-05
686,5,3,2,0.5,0.0002892286139369455
687,4,2,2,1.0,0.0002699402250539949
688,1,0,1,0.0,6.45240993381665e-05
689,4,1,3,0.0,9.003564603751244e-05
690,2,0,2,0.5,6.45240993381665e-05
691,6,2,4,0.0,0.00012800724370289952
692,7,1,6,0.3,0.0001767820809343085
693,4,2,2,0.0,0.00019868686937936337
694,8,4,4,0.0,0.0002203344848983039
695,18,9,9,0.4068965517241379,0.0006916859384658779
696,53,41,12,0.036949685534591194,0.0023875571935626024
697,7,6,1,0.09523809523809523,0.00034746425074747635
698,1,0,1,0.0,6.45240993381665e-05
699,8,3,5,0.3148148148148148,0.00023938138433041156
700,11,5,6,0.3584905660377358,0.0003745506500804174
701,3,1,2,0.0,0.0001122234006173161
702,5,2,3,0.0,0.00014077818735557136
703,8,2,6,0.28846153846153844,9.318467579243839e-05
704,6,3,3,0.03333333333333333,0.00012832992669176496
705,16,6,10,0.48695652173913045,0.0002303216163307961
706,7,2,5,0.1,0.00011768685427530995
707,5,2,3,0.1111111111111111,9.598411616888116e-05
708,118,88,30,0.042900075131480093,0.005821152516020871
709,6,1,5,0.03571428571428571,0.00011545828212625242
710,2,1,1,0.0,0.0004291135815339865
711,17,10,7,0.32575757575757575,0.0003045949245269889
712,4,1,3,0.0,9.54289658954663e-05
713,78,55,23,0.06638418079096045,0.004456579204274823
714,15,11,4,0.09090909090909091,0.0006196509445870605
715,24,12,12,0.6031390134529148,0.0005842829414746003
716,6,1,5,1.0,7.77406846476358e-05
717,3,1,2,1.0,0.0001514362025719723
718,17,17,0,0.2757352941176471,0.0013834835149380807
719,7,3,4,0.125,0.00014528373340999627
720,20,8,12,0.43169398907103823,0.0003169452957208688
721,8,2,6,0.21428571428571427,0.00026757751727254025
722,13,9,4,0.4864864864864865,0.0005850363740760971
723,29,17,12,0.3965014577259475,0.0005206149101001173
724,3,1,2,0.0,0.0001122234006173161
725,12,6,6,1.0,0.00028562041481492367
726,4,1,3,1.0,9.003564603751244e-05
727,3,1,2,0.0,8.699770283837449e-05
728,1,0,1,0.0,6.45240993381665e-05
729,22,11,11,0.4918918918918919,0.00034091021626396354
730,6,3,3,0.08333333333333333,0.00020067241323994397
731,4,3,1,0.3333333333333333,0.00015086938707701322
732,4,1,3,0.0,9.003564603751244e-05
733,18,14,4,0.058823529411764705,0.0007790319778571711
734,34,20,14,0.25564681724845995,0.0018421505279509578
735,15,6,9,0.43434343434343436,0.00024087506466114424
736,10,5,5,0.08139534883720931,0.00027507427308879994
737,5,1,4,0.2777777777777778,0.00011086197535583819
738,7,2,5,0.6111111111111112,0.00039778034594921977
739,4,2,2,0.0,0.00014402293480341583
740,9,1,8,0.023809523809523808,7.219520658272641e-05
741,3,0,3,0.16666666666666666,6.45240993381665e-05
742,20,8,12,0.20945945945945946,0.0004989321120013654
743,5,1,4,0.0,8.193652845627633e-05
744,6,2,4,0.0,0.000127014942423652
745,17,3,14,0.42718446601941745,0.00013330925449938133
746,6,1,5,0.16666666666666666,7.77406846476358e-05
747,11,6,5,1.0,0.00037464647415771365
748,8,2,6,0.42857142857142855,0.00010650195384250295
749,33,19,14,0.44052863436123346,0.000814904119125299
750,24,13,11,0.32286995515695066,0.0008144912806446257
751,25,9,16,0.422680412371134,0.00030596874394904055
752,3,0,3,1.0,6.45240993381665e-05
753,3,1,2,0.0,0.0001122234006173161
754,6,1,5,0.0,7.77406846476358e-05
755,10,6,4,0.08928571428571429,0.0003244301924866911
756,2,0,2,0.0,6.45240993381665e-05
757,16,5,11,0.691304347826087,0.00018922104235794403
758,8,3,5,0.25,0.00014240690059941018
759,3,1,2,0.0,0.0001122234006173161
760,16,11,5,0.06111111111111111,0.0006562634396980432
761,34,18,16,0.3979381443298969,0.0008207392288531336
762,19,8,11,0.4420731707317073,0.0007691289001770503
763,1,0,1,0.0,6.45240993381665e-05
764,3,0,3,0.0,6.45240993381665e-05
765,8,2,6,0.15384615384615385,9.31846757924384e-05
766,12,5,7,0.8442622950819673,0.00018579948431652932
767,4,1,3,0.5,9.003564603751244e-05
768,3,0,3,0.0,6.45240993381665e-05
769,2,1,1,0.5,6.874316530864292e-05
770,9,3,6,0.3787878787878788,0.00013014712995268305
771,19,5,14,0.22058823529411764,0.00015105337878921783
772,22,12,10,0.273224043715847,0.0010398979970679548
773,3,1,2,0.0,0.0001122234006173161
774,10,5,5,0.72,0.00019907077873047063
775,13,5,8,0.5490196078431373,0.00018353710179011784
776,40,23,17,0.19247467438494936,0.0017385272691503996
777,2,0,2,0.0,6.45240993381665e-05
778,7,1,6,0.125,8.019389009524565e-05
779,7,2,5,0.3,9.215360329026045e-05
780,3,2,1,0.0,0.0007332664499927782
781,24,11,13,0.5089686098654709,0.0004687998907755662
782,6,2,4,0.0,0.0013193848170229296
783,3,0,3,0.16666666666666666,6.45240993381665e-05
784,8,2,6,0.14285714285714285,0.00022314715293563376
785,7,3,4,0.25,0.00020938115561721022
786,10,5,5,0.018518518518518517,0.0002137158486578379
787,9,3,6,0.25757575757575757,0.0001631802715280981
788,16,10,6,0.37719298245614036,0.0007147854198958246
789,14,6,8,0.453125,0.0003340477376014766
790,10,4,6,0.47619047619047616,0.0003786536100074958
791,8,4,4,0.68,0.0003564543106656687
792,5,1,4,0.1,7.966745400642587e-05
793,9,3,6,0.275,0.00045428619592021677
794,27,11,16,0.5637931034482758,0.0004846198769369692
795,16,4,12,0.20555555555555555,0.00010962802541412666
796,2,0,2,1.0,6.45240993381665e-05
797,21,10,11,0.7760736196319018,0.00046922792487144875
798,4,1,3,1.0,9.003564603751244e-05
799,1,0,1,0.0,6.45240993381665e-05
800,2,0,2,0.5,6.45240993381665e-05
801,7,1,6,0.25,7.517432005016391e-05
802,7,2,5,0.3157894736842105,9.092796524866461e-05
803,16,6,10,0.6744186046511628,0.00021460305144337284
804,15,5,10,0.16,0.0004582936912116467
805,25,15,10,0.4146341463414634,0.0005728033667758693
806,8,4,4,0.5925925925925926,0.00015334828493848514
807,9,5,4,0.3333333333333333,0.0011235719438648874
808,35,20,15,0.34192439862542956,0.0007306666795390204
809,4,2,2,0.2,0.00015659890977692343
810,10,4,6,0.6707317073170732,0.00016075062440521363
811,13,5,8,0.5192307692307693,0.00030212333594611317
812,1,0,1,0.0,6.45240993381665e-05
813,5,1,4,0.3333333333333333,8.193652845627633e-05
814,34,23,11,0.26899383983572894,0.001986938787952688
815,7,2,5,0.7894736842105263,0.0001104823272570162
816,9,4,5,0.175,0.0002361705303819916
817,4,0,4,0.16666666666666666,6.45240993381665e-05
818,37,23,14,0.19250425894378195,0.0018499330323759422
819,30,17,13,0.32972972972972975,0.0006120500796478882
820,8,4,4,1.0,0.0004393786486840992
821,6,2,4,0.9285714285714286,0.00021657860596103974
822,3,1,2,1.0,0.0002290604096442164
823,3,0,3,0.0,6.45240993381665e-05
824,2,1,1,0.0,0.00012752210409322658
825,9,3,6,0.14285714285714285,0.00020198591546616483
826,5,4,1,0.3333333333333333,0.0007378321597349516
827,33,20,13,0.40899122807017546,0.0007786538498777746
828,3,1,2,0.0,0.00014622311387223528
829,9,3,6,0.8636363636363636,0.00014469655049988294
830,8,2,6,0.0,0.00010687176130545859
831,3,0,3,0.0,6.45240993381665e-05
832,26,12,14,0.5365079365079365,0.0004950893718652777
833,23,13,10,0.6475409836065574,0.0005679561087843496
834,4,2,2,0.2,0.00015659890977692343
835,4,0,4,0.08333333333333333,6.45240993381665e-05
836,4,1,3,0.9,8.989800166446342e-05
837,3,1,2,0.0,0.0001122234006173161
838,8,1,7,0.9,7.344255600195866e-05
839,12,4,8,0.4838709677419355,0.0001658996881635662
840,1,0,1,0.0,6.45240993381665e-05
841,7,4,3,0.875,0.0006593014490471972
842,2,0,2,1.0,6.45240993381665e-05
843,2,1,1,0.0,0.0003011697971483468
844,2,1,1,0.0,0.0004291135815339865
845,7,6,1,0.0,0.0028002295631949377
846,6,3,3,0.0,0.00016231109921779937
847,4,2,2,0.0,0.0005570573659196263
848,17,16,1,0.009523809523809525,0.006557565525704971
849,22,17,5,0.13829787234042554,0.0008179965824314823
850,5,0,5,0.1,6.45240993381665e-05
851,19,12,7,0.22727272727272727,0.0015582498543246985
852,3,0,3,0.8333333333333334,6.45240993381665e-05
853,6,3,3,0.4,0.0002362773368154009
854,16,5,11,0.40869565217391307,0.0003477326539894172
855,5,4,1,0.0,0.001069729957936229
856,8,4,4,0.6153846153846154,0.0006196583377565542
857,4,0,4,0.25,6.45240993381665e-05
858,3,1,2,0.0,0.0001122234006173161
859,21,10,11,0.4431137724550898,0.00043302769969295803
860,9,0,9,0.3055555555555556,6.45240993381665e-05
861,3,0,3,0.3333333333333333,6.45240993381665e-05
862,7,2,5,0.14285714285714285,0.00010582501754624107
863,2,0,2,0.0,6.45240993381665e-05
864,6,3,3,0.7,0.00012562654812899444
865,2,0,2,0.0,6.45240993381665e-05
866,23,16,7,0.040865384615384616,0.001100198745176781
867,4,0,4,0.4166666666666667,6.45240993381665e-05
868,5,1,4,0.3333333333333333,8.193652845627633e-05
869,4,1,3,1.0,9.003564603751244e-05
870,7,1,6,0.15,0.00012006853755466417
871,7,2,5,0.5,0.00010591601224805216
872,1,0,1,0.0,6.45240993381665e-05
873,1,0,1,0.0,6.45240993381665e-05
874,8,4,4,0.0,0.00020373225311264955
875,2,1,1,0.0,0.0004291135815339865
876,4,1,3,0.6,8.253096133679489e-05
877,4,2,2,0.0,0.00015911974239306818
878,5,2,3,0.0,0.00012800724370289952
879,2,0,2,0.0,6.45240993381665e-05
880,3,1,2,0.0,0.0001122234006173161
881,4,2,2,0.08333333333333333,9.550533231025989e-05
882,11,6,5,0.22115384615384615,0.0005278408848663502
883,5,2,3,0.0,0.00012317551415085102
884,2,0,2,0.0,6.45240993381665e-05
885,4,2,2,0.0,0.000890345199317493
886,11,5,6,0.8,0.00029449861200862046
887,25,14,11,0.5996563573883161,0.0004008108371167541
888,5,0,5,0.1,6.45240993381665e-05
889,6,2,4,0.4,0.00029672681884005216
890,29,28,1,0.18233618233618235,0.007586262379569607
891,5,0,5,0.35,6.45240993381665e-05
892,3,0,3,0.0,6.45240993381665e-05
893,17,10,7,0.32524271844660196,0.00038139917861716927
894,4,1,3,0.0,0.00015936561498948473
895,14,12,2,0.08461538461538462,0.0007656285060626286
896,10,5,5,1.0,0.0002873448868172141
897,4,0,4,0.5,6.45240993381665e-05
898,4,1,3,0.0,9.003564603751244e-05
899,1,0,1,0.0,6.45240993381665e-05
900,6,3,3,0.0,0.00018286485848124047
901,8,2,6,0.14285714285714285,0.00016203787777075953
902,13,9,4,0.025974025974025976,0.00045430522305309857
903,7,4,3,0.3157894736842105,0.0001978976463946824
904,6,2,4,0.21428571428571427,0.00014766636298180907
905,7,0,7,0.07142857142857142,6.45240993381665e-05
906,3,1,2,0.0,0.0001122234006173161
907,6,2,4,0.5,0.00015158624492871565
908,6,2,4,0.0,0.00011522449017293067
909,8,4,4,0.07142857142857142,0.000277009190467711
910,6,3,3,0.7,0.00031106899180684814
911,11,5,6,0.8,0.00029449861200862046
912,1,0,1,0.0,6.45240993381665e-05
913,4,0,4,0.25,6.45240993381665e-05
914,7,1,6,0.0,7.517432005016391e-05
915,10,4,6,0.05555555555555555,0.00015661995770241218
916,12,7,5,0.2857142857142857,0.0003600208799149984
917,9,4,5,0.45588235294117646,0.00021595041487027595
918,11,4,7,0.39622641509433965,0.0002644361028348342
919,5,3,2,0.5,0.00023100505830341527
920,18,9,9,0.9861111111111112,0.0003300845266556428
921,18,9,9,0.9861111111111112,0.0003300845266556428
922,31,20,11,0.027227722772277228,0.0006254965137031892
923,7,3,4,0.3333333333333333,0.00019225908984888036
924,7,0,7,0.19047619047619047,6.45240993381665e-05
925,3,1,2,0.0,0.0001122234006173161
926,13,6,7,0.8,0.0003363758881534314
927,8,2,6,0.08928571428571429,0.0001053936357796351
928,10,5,5,1.0,0.0002873448868172141
929,8,4,4,0.21153846153846154,0.00033679555749695044
930,10,9,1,0.022222222222222223,0.0002083254694526865
931,30,14,16,0.47287735849056606,0.0004606620971923628
932,25,20,5,0.08366533864541832,0.000756093356851455
933,23,17,6,0.03398058252427184,0.0012537605778021935
934,10,0,10,0.7111111111111111,6.45240993381665e-05
935,10,2,8,0.6976744186046512,0.00012031827048881769
936,4,3,1,0.0,0.0011691586986786648
937,7,3,4,0.3333333333333333,0.00013732583139839145
938,10,2,8,0.5340909090909091,0.0001397568523090062
939,11,3,8,0.5,0.00014462090879932674
940,15,7,8,0.2107843137254902,0.0003184351700162444
941,16,6,10,0.3991228070175439,0.0001763126879778052
942,8,3,5,0.46153846153846156,0.0001431588357356699
943,12,0,12,0.7272727272727273,6.45240993381665e-05
944,2,1,1,0.0,0.0004291135815339865
945,6,2,4,0.46153846153846156,0.00011806322768024839
946,4,0,4,0.08333333333333333,6.45240993381665e-05
947,2,0,2,0.0,6.45240993381665e-05
948,5,1,4,0.16666666666666666,8.193652845627633e-05
949,11,0,11,0.8272727272727273,6.45240993381665e-05
950,23,12,11,0.8059701492537313,0.00037297527510050574
951,1,1,0,0.0,8.280671854356432e-05
952,5,2,3,0.625,0.00032574525359067494
953,3,1,2,0.0,0.0001122234006173161
954,3,2,1,0.0,0.0005879747399520271
955,30,13,17,0.516260162601626,0.00038836200328621636
956,3,2,1,0.0,9.377629006680302e-05
957,4,1,3,0.0,8.67300168876473e-05
958,1,0,1,0.0,6.45240993381665e-05
959,1,0,1,0.0,6.45240993381665e-05
960,43,28,15,0.05719557195571956,0.0011085481500061288
961,9,3,6,0.42424242424242425,0.00017957442173381725
962,34,17,17,0.030364372469635626,0.0009252381308478411
963,2,0,2,0.5,6.45240993381665e-05
964,11,3,8,0.5384615384615384,0.00014462090879932674
965,13,3,10,0.12037037037037036,0.00013789962511920074
966,8,2,6,0.5,9.383327443258054e-05
967,17,7,10,0.2696078431372549,0.0003025731110790133
968,6,1,5,0.07142857142857142,9.038179830058896e-05
969,8,5,3,0.32,0.0002159492361350067
970,12,2,10,0.29545454545454547,0.000258796933971895
971,7,3,4,0.35,0.00011851809434180018
972,19,13,6,0.05970149253731343,0.0005377270602941009
973,8,3,5,0.07142857142857142,0.00016472339122820112
974,2,1,1,0.0,0.0004291135815339865
975,37,20,17,0.34192439862542956,0.0008342427955862877
976,5,1,4,0.3333333333333333,8.193652845627633e-05
977,4,0,4,0.3333333333333333,6.45240993381665e-05
978,12,5,7,0.07142857142857142,0.00040397484996851574
979,6,3,3,0.7,0.00016737552327728808
980,10,2,8,0.05357142857142857,0.00015766054771908458
981,6,0,6,0.1,6.45240993381665e-05
982,23,13,10,0.038834951456310676,0.000873427429890223
983,7,4,3,0.3157894736842105,0.00034844639555698916
984,13,8,5,0.3333333333333333,0.0010830440734968451
985,8,0,8,0.19642857142857142,6.45240993381665e-05
986,5,1,4,0.16666666666666666,8.193652845627633e-05
987,4,1,3,0.0,8.564747347216245e-05
988,6,2,4,0.08333333333333333,0.00011380834813841848
989,3,1,2,0.0,0.0001122234006173161
990,20,10,10,0.04304635761589404,0.0005551772066573487
991,9,4,5,0.3787878787878788,0.00019434895909106053
992,19,9,10,0.2803030303030303,0.00030395096355284677
993,11,5,6,0.3484848484848485,0.0007026000070900691
994,6,2,4,0.5,0.00015332413713429967
995,5,2,3,0.0,0.0014501797289749613
996,7,3,4,0.1,0.0001245117870200769
997,5,3,2,0.0,0.00022285946128313674
998,10,4,6,0.4878048780487805,0.00018634782396926517
999,35,21,14,0.3817829457364341,0.0007090275711298231
1000,10,5,5,1.0,0.0002873448868172141
1001,5,1,4,0.16666666666666666,8.193652845627633e-05
1002,19,14,5,0.10479041916167664,0.0010082348271379063
1003,3,3,0,1.0,0.0001431588357356699
1004,3,0,3,0.0,6.45240993381665e-05
1005,23,7,16,0.14919354838709678,0.0004914473204269852
1006,5,2,3,0.0,0.00011554719273685837
1007,18,13,5,0.0847457627118644,0.0005826531545313696
1008,7,4,3,0.0,0.00016695590391500295
1009,11,6,5,0.08333333333333333,0.00030212483989804914
1010,8,1,7,0.5185185185185185,7.587202724827416e-05
1011,8,1,7,0.1,7.344255600195866e-05
1012,12,3,9,0.29365079365079366,0.00012011392939087674
1013,3,1,2,0.0,0.0001122234006173161
1014,3,1,2,0.0,0.0001122234006173161
1015,5,1,4,0.0,8.193652845627633e-05
1016,11,5,6,0.07142857142857142,0.00019544652295679974
1017,3,0,3,0.0,6.45240993381665e-05
1018,7,2,5,0.1111111111111111,0.00010919425472627099
1019,3,0,3,0.0,6.45240993381665e-05
1020,10,3,7,0.4186046511627907,0.00011722286021862624
1021,7,3,4,0.0,0.000205135035301445
1022,13,5,8,0.009259259259259259,0.00017788045436304095
1023,10,3,7,0.0,0.00014426335615858786
1024,19,10,9,0.24848484848484848,0.00040755847923842355
1025,2,0,2,1.0,6.45240993381665e-05
1026,1,0,1,0.0,6.45240993381665e-05
1027,2,0,2,0.0,6.45240993381665e-05
1028,19,9,10,0.044444444444444446,0.0003745463103467053
1029,4,3,1,0.3,0.0002219711317970882
1030,3,0,3,0.5,6.45240993381665e-05
1031,3,1,2,0.5,8.600449862889154e-05
1032,6,0,6,0.03333333333333333,6.45240993381665e-05
1033,8,4,4,0.48,0.00019771570246929546
1034,18,8,10,0.9379310344827586,0.000249050430079507
1035,1,0,1,0.0,6.45240993381665e-05
1036,16,8,8,0.06111111111111111,0.0003594868039279062
1037,4,1,3,0.0,9.003564603751244e-05
1038,1,0,1,0.0,6.45240993381665e-05
1039,3,1,2,0.0,0.0001122234006173161
1040,5,2,3,0.0,0.00011918667545757975
1041,1,0,1,0.0,6.45240993381665e-05
1042,5,2,3,0.875,0.00012068314509234498
1043,13,5,8,0.589041095890411,0.00015343617135409865
1044,5,2,3,0.5,0.00013781615038337437
1045,12,6,6,0.36904761904761907,0.00026683213305468196
1046,11,4,7,0.08571428571428572,0.0002327257019678835
1047,6,2,4,0.0,0.00011433299878122076
1048,5,1,4,0.0,9.829685093678881e-05
1049,6,1,5,0.14285714285714285,9.409716321254294e-05
1050,12,4,8,0.10465116279069768,0.00017456185550972336
1051,11,4,7,0.5151515151515151,0.0001490103138304305
1052,6,2,4,0.0,0.00015409410705744095
1053,18,8,10,0.9379310344827586,0.00024905043007950696
1054,6,2,4,0.38461538461538464,0.00012824817401260963
1055,15,6,9,0.2465753424657534,0.00022353653867730774
1056,11,3,8,0.09259259259259259,0.00016153735959402964
1057,11,4,7,0.10576923076923077,0.00019219446113222138
1058,5,2,3,0.5,0.00013013337035031237
1059,3,1,2,0.0,0.0001122234006173161
1060,3,0,3,0.0,6.45240993381665e-05
1061,8,3,5,0.5384615384615384,0.00014474673731629234
1062,9,5,4,0.3181818181818182,0.00020346602572031509
1063,7,2,5,0.15,9.976832683008463e-05
1064,27,14,13,0.189419795221843,0.0005931806972904682
1065,10,3,7,0.07692307692307693,0.00016524643448606507
1066,6,3,3,0.2,0.0003878545701112678
1067,6,3,3,0.0,0.00018926861546369813
1068,1,0,1,0.0,6.45240993381665e-05
1069,2,0,2,0.0,6.45240993381665e-05
1070,9,3,6,0.3157894736842105,0.00015552582525350355
1071,15,8,7,0.039473684210526314,0.00043553985857522945
1072,20,9,11,0.9379310344827586,0.0002702905738206665
1073,20,8,12,0.2554347826086957,0.00037877262611655605
1074,13,7,6,0.04807692307692308,0.0002560502775127209
1075,7,4,3,0.07894736842105263,0.0001546031665003464
1076,3,0,3,0.0,6.45240993381665e-05
1077,9,4,5,0.18181818181818182,0.00017791972924100776
1078,8,3,5,0.3076923076923077,0.00014022414022331494
1079,10,4,6,0.21951219512195122,0.00015205420827277033
1080,5,1,4,0.16666666666666666,0.00010107802889480029
1081,10,5,5,0.12790697674418605,0.0002101505078847592
1082,6,2,4,0.03571428571428571,0.00014242912906023165
1083,8,4,4,1.0,0.00022227714899591082
1084,11,4,7,0.05714285714285714,0.00020641055581980533
1085,8,3,5,0.3076923076923077,0.0001269086454782294
1086,8,5,3,0.15384615384615385,0.0006822836399936967
1087,10,6,4,0.4,0.00038753693679437044
1088,3,1,2,0.0,7.36654089408654e-05
1089,20,13,7,0.3333333333333333,0.0005328950936667737
1090,4,1,3,0.0,9.003564603751244e-05
1091,9,1,8,0.023809523809523808,7.219520658272641e-05
1092,13,7,6,0.046296296296296294,0.00020866952916024292
1093,5,3,2,0.0,0.00031778856473402403
1094,17,7,10,0.30303030303030304,0.00028268233044560965
1095,28,14,14,0.19482288828337874,0.0005807093669772715
1096,17,10,7,0.8,0.00033429085033840207
1097,11,6,5,0.058823529411764705,0.0003047204515142992
1098,5,2,3,0.0,0.0001717578985908443
1099,5,3,2,0.125,0.0005953872778774779
1100,4,1,3,0.0,9.003564603751244e-05
1101,7,3,4,0.1111111111111111,0.00017188352634570694
1102,10,4,6,0.56,0.0001490103138304305
1103,1,0,1,0.0,6.45240993381665e-05
1104,14,3,11,0.044444444444444446,0.00012245826288216294
1105,10,4,6,0.56,0.0001490103138304305
1106,7,2,5,0.5555555555555556,0.00012616555824362886
1107,2,1,1,0.0,0.0004291135815339865
1108,10,5,5,0.25,0.00024481145782104583
1109,3,1,2,0.0,0.0001122234006173161
1110,35,16,19,0.3156370656370656,0.0005580172326348459
1111,22,11,11,0.8777777777777778,0.0003750341780815809
1112,3,1,2,0.0,0.0001122234006173161
1113,2,1,1,0.0,0.0004291135815339865
1114,14,7,7,0.3770491803278688,0.00032923302819254504
1115,6,2,4,0.0,0.00019680720409800094
1116,2,1,1,0.0,0.00010636537045520479
1117,20,9,11,0.8176795580110497,0.00028865035627768167
1118,2,1,1,0.0,0.0004291135815339865
1119,6,2,4,0.2,0.00032249060256565686
1120,4,2,2,0.0,0.00027927048573826924
1121,4,1,3,0.3,0.0001014001100989494
1122,4,0,4,0.5,6.45240993381665e-05
1123,4,2,2,0.0,0.00010823816199170864
1124,3,1,2,0.0,9.194802814626324e-05
1125,7,1,6,0.023809523809523808,8.280671854356432e-05
1126,3,3,0,0.0,0.00015389919096628853
1127,6,3,3,0.0,0.00019971475259763946
1128,9,3,6,0.14285714285714285,0.00012661443996580233
1129,3,0,3,0.16666666666666666,6.45240993381665e-05
1130,10,5,5,0.11538461538461539,0.00021199476808773766
1131,16,11,5,0.8068181818181818,0.0003750341780815809
1132,3,1,2,0.0,0.0001122234006173161
1133,6,1,5,0.0,7.77406846476358e-05
1134,3,1,2,0.0,0.0001122234006173161
1135,3,0,3,0.3333333333333333,6.45240993381665e-05
1136,5,2,3,0.5,0.00014108161475442075
1137,20,9,11,0.9379310344827586,0.00027029057382066656
1138,3,0,3,0.0,6.45240993381665e-05
1139,2,1,1,0.0,0.0004291135815339865
1140,3,0,3,0.0,6.45240993381665e-05
1141,14,7,7,0.19318181818181818,0.00031116350418798123
1142,6,2,4,0.9,0.0001042310450591916
1143,14,13,1,0.0,0.0004483975343984828
1144,6,2,4,0.4,0.0003281525167365748
1145,3,1,2,0.5,0.00010927541405808295
1146,2,0,2,0.0,6.45240993381665e-05
1147,2,1,1,0.0,0.0004291135815339865
1148,2,0,2,0.0,6.45240993381665e-05
1149,6,3,3,0.0,0.00029817557714084615
1150,5,2,3,0.0,9.125724490128837e-05
1151,14,6,8,0.5176470588235295,0.00017292321883363972
1152,12,5,7,0.7213114754098361,0.00015135791439175016
1153,11,5,6,0.86,0.00014867295983124918
1154,15,6,9,0.589041095890411,0.00016975283351655394
1155,16,7,9,0.1686046511627907,0.0006184092978662051
1156,13,6,7,0.4230769230769231,0.0002621665936742627
1157,6,2,4,0.0,0.0001420011472508311
1158,6,2,4,0.38461538461538464,0.00010466267912003661
1159,4,1,3,0.0,9.003564603751244e-05
1160,19,9,10,0.9135802469135802,0.00028658807780488173
1161,6,0,6,0.23333333333333334,6.45240993381665e-05
1162,3,1,2,0.5,0.000133285030503474
1163,14,6,8,0.4647058823529412,0.000298619668028998
1164,27,9,18,0.17235494880546076,0.00034585553658973104
1165,24,16,8,0.27232142857142855,0.0005268360853388324
1166,23,16,7,0.24390243902439024,0.0005153724473806014
1167,1,1,0,0.0,8.457264479064272e-05
1168,7,3,4,0.1111111111111111,0.0002105699897348485
1169,3,0,3,0.16666666666666666,6.45240993381665e-05
1170,12,7,5,0.03125,0.0010638482113593186
1171,8,3,5,0.21428571428571427,0.00011382829078756279
1172,15,6,9,0.3581081081081081,0.00019072964907227856
1173,15,6,9,0.35135135135135137,0.00019740957260087097
1174,15,6,9,0.35135135135135137,0.0002118412640645938
1175,14,6,8,0.313953488372093,0.0002131561631376703
1176,24,17,7,0.12730627306273062,0.0008493520262523771
1177,22,11,11,0.13978494623655913,0.00039480985834234835
1178,13,4,9,0.1891891891891892,0.00018556448344778773
1179,8,2,6,0.7142857142857143,0.00021601553771984815
1180,8,3,5,0.42857142857142855,0.00016530511948190566
1181,5,1,4,0.3333333333333333,8.193652845627633e-05
1182,3,0,3,0.8333333333333334,6.45240993381665e-05
1183,6,2,4,0.10714285714285714,0.00011966954110516118
1184,9,3,6,0.10526315789473684,0.00018369840678998076
1185,11,6,5,0.5303030303030303,0.00020240696377080624
1186,2,1,1,0.0,0.00012326565418615225
1187,1,0,1,0.0,6.45240993381665e-05
1188,10,5,5,1.0,0.000173551683961667
1189,23,10,13,0.746268656716418,0.0003110339015638453
1190,19,9,10,0.3769230769230769,0.00034415032030308233
1191,14,8,6,0.19186046511627908,0.00031177894073804066
1192,11,2,9,0.2830188679245283,0.00010702978787390558
1193,4,2,2,0.0,0.00020762200317561534
1194,3,2,1,1.0,0.0003281525167365748
1195,7,2,5,0.0,0.0001092029273600645
1196,5,2,3,0.16666666666666666,0.00012076379858894117
1197,11,6,5,0.1111111111111111,0.0003732581793915957
1198,4,1,3,1.0,9.003564603751244e-05
1199,2,1,1,0.0,0.0004291135815339865
1200,3,0,3,0.16666666666666666,6.45240993381665e-05
1201,9,4,5,0.014705882352941176,0.00018886268447756331
1202,4,0,4,0.08333333333333333,6.45240993381665e-05
1203,5,4,1,0.3333333333333333,0.0014424897260448776
1204,4,1,3,0.6,8.09176226919596e-05
1205,4,0,4,0.4166666666666667,6.45240993381665e-05
1206,6,2,4,0.07692307692307693,0.00012093527751572208
1207,4,1,3,0.0,9.003564603751244e-05
1208,18,11,7,0.10504201680672269,0.00046143731742038927
1209,4,2,2,1.0,0.00013207365044552673
1210,2,0,2,0.0,6.45240993381665e-05
1211,31,13,18,0.24050632911392406,0.0009533511930883584
1212,5,1,4,0.2222222222222222,8.692170226292334e-05
1213,22,11,11,0.6777777777777778,0.0006267141795401288
1214,8,2,6,0.5,9.626176822718318e-05
1215,3,0,3,0.16666666666666666,6.45240993381665e-05
1216,6,3,3,0.0,0.0001527442672108277
1217,2,1,1,0.0,0.00010909669470694671
1218,13,2,11,0.10909090909090909,9.323571506799966e-05
1219,15,7,8,0.8571428571428571,0.0002837757589321137
1220,1,0,1,0.0,6.45240993381665e-05
1221,5,2,3,0.5,0.00010916930606202189
1222,4,1,3,0.5,9.003564603751244e-05
1223,19,7,12,0.6219512195121951,0.0002931926366356396
1224,21,8,13,0.5242424242424243,0.000219465758228289
1225,1,0,1,0.0,6.45240993381665e-05
1226,9,2,7,0.11904761904761904,0.00010422759640449194
1227,16,8,8,0.8117647058823529,0.000219465758228289
1228,18,7,11,0.5684931506849316,0.00020369545268739578
1229,12,7,5,0.045454545454545456,0.0003614284830391795
1230,4,0,4,0.0,6.45240993381665e-05
1231,7,3,4,0.0,0.00011419665526939142
1232,18,8,10,0.8,0.00046179446784562803
1233,3,0,3,0.16666666666666666,6.45240993381665e-05
1234,13,8,5,0.09259259259259259,0.0003287101956439907
1235,2,1,1,0.0,0.0004291135815339865
1236,10,5,5,1.0,0.00015923728492766266
1237,6,2,4,0.4,0.0001394223683885253
1238,8,4,4,0.0,0.00028748898156758873
1239,11,5,6,0.07142857142857142,0.0002153997791059538
1240,5,1,4,0.16666666666666666,0.00010129652195231575
1241,3,1,2,0.0,0.00019991868554177135
1242,4,1,3,0.16666666666666666,0.00011257922375160826
1243,4,1,3,0.4,0.0002686172856119203
1244,20,7,13,0.5765027322404371,0.00029469717668246517
1245,10,4,6,0.038461538461538464,0.0001905517663804038
1246,14,6,8,0.7950819672131147,0.00018798416568501522
1247,23,17,6,0.06009615384615385,0.0008984571739845688
1248,7,1,6,0.2,7.517432005016391e-05
1249,5,2,3,0.5,0.00010489697202486096
1250,20,10,10,0.8103448275862069,0.000599790404830528
1251,12,5,7,0.7950819672131147,0.00016760452172195103
1252,4,1,3,1.0,9.003564603751244e-05
1253,20,8,12,0.44565217391304346,0.0002241691873364165
1254,2,1,1,0.0,0.00012579721731449756
1255,24,11,13,0.3783783783783784,0.00039573014331156797
1256,6,2,4,0.4,0.00010539363577963509
1257,10,4,6,0.05813953488372093,0.00022752269230159888
1258,17,8,9,0.8828125,0.00045780100833125965
1259,9,4,5,0.631578947368421,0.0003322632722065047
1260,4,1,3,0.0,9.003564603751244e-05
1261,37,25,12,0.19642857142857142,0.0014039081558235619
1262,20,9,11,0.7307692307692307,0.00033536861956569
1263,7,3,4,0.05,0.00013245098171510872
1264,49,34,15,0.12289719626168225,0.0017350651553804802
1265,10,4,6,0.4166666666666667,0.00013949277397500083
1266,10,5,5,0.48,0.0002591796501027583
1267,2,0,2,0.0,6.45240993381665e-05
1268,4,0,4,0.25,6.45240993381665e-05
1269,18,7,11,0.17543859649122806,0.0003138883196698601
1270,13,5,8,0.5098039215686274,0.00015923728492766266
1271,11,5,6,0.42424242424242425,0.0001956918658589495
1272,19,9,10,0.3549618320610687,0.0006065606671357542
1273,2,1,1,0.0,0.0004291135815339865
1274,13,5,8,0.6164383561643836,0.0001699068799377267
1275,7,2,5,0.3684210526315789,0.00012841372626966552
1276,4,1,3,0.0,0.00015726280578995397
1277,9,5,4,0.0,0.00024150281750195908
1278,17,8,9,0.875,0.00045780100833125965
1279,3,1,2,0.0,0.0001122234006173161
1280,4,1,3,0.0,9.003564603751244e-05
1281,18,11,7,0.1623931623931624,0.0007446336329010251
1282,5,3,2,0.0,0.0003173482564690558
1283,9,2,7,0.14705882352941177,0.00016930129023993176
1284,14,4,10,0.23809523809523808,0.00017385172938684003
1285,2,1,1,0.0,0.0004291135815339865
1286,5,2,3,0.0,0.0001256346475971745
1287,9,0,9,0.1111111111111111,6.45240993381665e-05
1288,3,1,2,1.0,0.00016041398986803683
1289,2,0,2,0.0,6.45240993381665e-05
1290,8,4,4,1.0,0.00024969629932420674
1291,13,5,8,0.5882352941176471,0.00015923728492766266
1292,3,0,3,0.16666666666666666,6.45240993381665e-05
1293,16,7,9,0.7522123893805309,0.00028684674034940727
1294,4,1,3,0.0,9.003564603751244e-05
1295,6,2,4,0.08333333333333333,0.00011433299878122076
1296,18,9,9,0.28695652173913044,0.0005504456099395635
1297,3,1,2,0.0,0.0001122234006173161
1298,10,4,6,0.03409090909090909,0.00017262242353449167
1299,23,16,7,0.22439024390243903,0.0008726507702192477
1300,9,4,5,0.5789473684210527,0.00028198325839051707
1301,8,4,4,0.03333333333333333,0.00016902398570908044
1302,9,6,3,0.2631578947368421,0.00033532820117425084
1303,16,8,8,1.0,0.00031403597402369075
1304,6,2,4,0.0,0.00019680720409800094
1305,2,1,1,0.0,0.00010636537045520479
1306,2,0,2,0.0,6.45240993381665e-05
1307,5,2,3,0.5,0.0001542690608029353
1308,17,7,10,0.37373737373737376,0.0004887903327648094
1309,1,0,1,0.0,6.45240993381665e-05
1310,31,10,21,0.12903225806451613,0.001184066787122398
1311,9,4,5,0.8888888888888888,0.0006353680262588208
1312,12,5,7,0.7950819672131147,0.00016760452172195106
1313,9,3,6,1.0,0.0001237930327521118
1314,19,12,7,0.05223880597014925,0.00048250403673368405
1315,8,3,5,0.3076923076923077,0.000202535379979615
1316,49,34,15,0.16089803554724041,0.001685508256008225
1317,10,2,8,0.3953488372093023,9.934481704346671e-05
1318,6,4,2,0.25,0.0002896379157390253
1319,11,5,6,0.88,0.00016463009387723875
1320,15,6,9,0.6868686868686869,0.00018445113855638007
1321,9,2,7,0.325,0.0001328359293154702
1322,8,3,5,0.06666666666666667,0.00012698217269059163
1323,4,2,2,0.0,0.00022286514805066248
1324,10,4,6,0.56,0.00017385172938684003
1325,2,0,2,0.0,6.45240993381665e-05
1326,21,13,8,0.3303030303030303,0.0010014041211512785
1327,1,0,1,0.0,6.45240993381665e-05
1328,34,18,16,0.3105590062111801,0.0010288450468444502
1329,16,7,9,0.5529411764705883,0.00022475658829916446
1330,52,42,10,0.08949096880131363,0.0023931402408284234
1331,32,20,12,0.08120649651972157,0.0005932333350980086
1332,7,3,4,0.6666666666666666,0.0002058260772758985
1333,24,11,13,0.57847533632287,0.0006107599763537667
1334,20,12,8,0.09602649006622517,0.000582644369014821
1335,6,3,3,0.16666666666666666,0.00019278697346860344
1336,1,0,1,0.0,6.45240993381665e-05
1337,12,4,8,0.5080645161290323,0.0001439320468544023
1338,10,5,5,0.4642857142857143,0.00015058326656527547
1339,3,0,3,0.3333333333333333,6.45240993381665e-05
1340,14,8,6,0.2,0.00042554793576520173
1341,6,3,3,0.2,0.0007124811499717043
1342,15,7,8,0.8979591836734694,0.0002837757589321137
1343,7,2,5,0.05555555555555555,0.00017416405896618467
1344,18,9,9,0.1016949152542373,0.0006894779269898201
1345,7,2,5,0.0,0.00010698544391016138
1346,8,3,5,0.0,0.0001510452573865752
1347,7,3,4,0.75,0.00015025386274177498
1348,17,8,9,0.22549019607843138,0.00038807758084837067
1349,5,1,4,0.3333333333333333,8.712219503761554e-05
1350,37,22,15,0.288527397260274,0.0011636088640710252
1351,22,10,12,0.17819148936170212,0.00036565537593152283
1352,15,8,7,0.5540540540540541,0.0005414989502831631
1353,14,3,11,0.05384615384615385,0.00012260598716264546
1354,7,3,4,0.6666666666666666,0.00020582607727589848
1355,4,1,3,0.0,9.003564603751244e-05
1356,19,10,9,0.8828125,0.0005968588991841036
1357,1,0,1,0.0,6.45240993381665e-05
1358,20,9,11,0.3219178082191781,0.0002385121056883099
1359,3,1,2,0.0,0.0001122234006173161
1360,16,8,8,1.0,0.00045290527126012534
1361,9,2,7,0.30952380952380953,9.183891311490049e-05
1362,1,0,1,0.0,6.45240993381665e-05
1363,20,9,11,0.5994475138121547,0.00042844382814982994
1364,4,3,1,0.0,0.00024082178138162797
1365,4,1,3,0.0,9.003564603751244e-05
1366,3,2,1,0.0,0.0005202609520829417
1367,2,0,2,0.0,6.45240993381665e-05
1368,5,2,3,0.0,0.00022286514805066248
1369,9,7,2,0.023809523809523808,0.0006957352647099696
1370,9,3,6,0.3939393939393939,0.0001831627415846603
1371,4,1,3,0.0,0.0001010605499427449
1372,5,2,3,0.625,0.0001466629031903471
1373,16,9,7,0.28735632183908044,0.0004889941765230554
1374,10,3,7,0.40476190476190477,0.00012836555033189976
1375,14,6,8,0.30952380952380953,0.00019907538416471908
1376,14,7,7,1.0,0.00020190486079111437
1377,5,0,5,0.2,6.45240993381665e-05
1378,5,0,5,0.1,6.45240993381665e-05
1379,9,3,6,0.05263157894736842,0.0002573120338889603
1380,7,3,4,0.75,0.00015025386274177498
1381,14,7,7,0.1875,0.00018601515722917482
1382,4,2,2,0.0,0.00015044484798595734
1383,4,1,3,0.0,9.003564603751244e-05
1384,5,2,3,0.5,0.000157759577718566
1385,16,10,6,0.02247191011235955,0.0004316519555742873
1386,2,0,2,0.0,6.45240993381665e-05
1387,13,7,6,0.09615384615384616,0.0005151237814169037
1388,3,1,2,0.0,0.0001122234006173161
1389,4,2,2,0.0,0.0002663275186576355
1390,13,8,5,0.10576923076923077,0.0004321630486168458
1391,6,3,3,0.3076923076923077,0.00024366962432788498
1392,6,3,3,1.0,0.00017622917713978962
1393,15,4,11,0.0641025641025641,0.000133809833327974
1394,25,14,11,0.7090163934426229,0.00042473799642267507
1395,2,1,1,0.0,0.0001374747680258661
1396,10,1,9,0.6704545454545454,0.00010801222893965732
1397,17,10,7,0.2087378640776699,0.0006666173178772136
1398,64,37,27,0.6057280513918629,0.0013908347628799533
1399,3,0,3,0.8333333333333334,6.45240993381665e-05
1400,38,13,25,0.5556451612903226,0.0003774076482338716
1401,37,22,15,0.2537878787878788,0.001680113686736339
1402,32,17,15,0.3755868544600939,0.00047847070586121084
1403,61,19,42,0.5093767236624379,0.0005387016503968686
1404,53,25,28,0.7942583732057417,0.0009823534071626643
1405,20,4,16,0.44680851063829785,0.0001559793055673794
1406,15,3,12,0.5192307692307693,0.0001058736355031774
1407,38,17,21,0.4602026049204052,0.0005098385519808644
1408,24,7,17,0.41228070175438597,0.00028035642581064396
1409,10,1,9,0.45454545454545453,9.147016073266499e-05
1410,43,11,32,0.5855911330049262,0.00035931682643471476
1411,62,29,33,0.7101947308132875,0.0010397566640778985
1412,135,98,37,0.19150760086867072,0.00450596749305579
1413,41,35,6,0.3008578431372549,0.0019132649496284048
1414,33,18,15,0.7122093023255814,0.000587880757658194
1415,17,1,16,0.45714285714285713,6.814443738444335e-05
1416,57,28,29,0.7486320109439124,0.0011036520005399627
1417,68,25,43,0.47883349012229537,0.0007465046874968238
1418,37,15,22,0.4727427597955707,0.0005000470451031389
1419,13,2,11,0.33636363636363636,7.898927520086481e-05
1420,44,13,31,0.5487089201877934,0.00039981926839638003
1421,40,23,17,0.3118668596237337,0.0008296541073377128
1422,15,4,11,0.43333333333333335,0.00017445923668545074
1423,68,23,45,0.4853788214443952,0.0006384053354491132
1424,23,11,12,0.3188405797101449,0.0007029269437339378
1425,17,8,9,0.4752475247524752,0.00027084492707250693
1426,4,1,3,0.7,7.796043807995726e-05
1427,18,4,14,0.6324786324786325,0.0002937724095990678
1428,54,26,28,0.7963246554364471,0.000990592622901291
1429,14,4,10,0.626984126984127,0.0002379137120626587
1430,59,44,15,0.3054156171284635,0.001479707941821084
1431,16,2,14,0.6313559322033898,0.00014186713764240968
1432,13,2,11,0.6666666666666666,0.0001236258271012818
1433,64,23,41,0.5211004273504274,0.00057674572606954
1434,97,57,40,0.4012861010830325,0.0020364777145069684
1435,35,10,25,0.6377649325626205,0.00027186853339900084
1436,24,11,13,0.41885964912280704,0.0004004944311863121
1437,7,0,7,0.07142857142857142,6.45240993381665e-05
1438,8,1,7,0.5357142857142857,0.00010391912596127148
1439,65,39,26,0.6298600311041991,0.0013904396197568932
1440,29,10,19,0.6464646464646465,0.0003201031698016533
1441,29,17,12,0.521865889212828,0.0006322080315064085
1442,54,26,28,0.7900383141762453,0.000990592622901291
1443,77,47,30,0.44678532509989105,0.0017905209422153805
1444,78,42,36,0.4723698193411265,0.0014607929876887435
1445,107,65,42,0.31434365781710916,0.002539534685592404
1446,78,44,34,0.5051345609065155,0.001551394157902576
1447,24,5,19,0.6397379912663755,0.00023274272619499623
1448,29,13,16,0.7131979695431472,0.0004678785018394712
1449,63,34,29,0.6064123825317855,0.00109833206608256
1450,21,16,5,0.32142857142857145,0.0014602523494177387
1451,40,7,33,0.42120343839541546,0.0003261606750187337
1452,25,11,14,0.5544217687074829,0.0004335944646651813
1453,22,4,18,0.7731277533039648,0.00017539382183257831
1454,15,5,10,0.6493506493506493,0.00023260920396136347
1455,9,5,4,0.375,0.0009216938952635454
1456,25,12,13,0.2963709677419355,0.00044222393450213295
1457,52,32,20,0.6552152317880795,0.0013794058712928426
1458,37,29,8,0.7420333839150227,0.0012362569648159956
1459,41,30,11,0.6732429099876696,0.0012840062506065326
1460,77,45,32,0.5229090909090909,0.001806014932838139
1461,51,25,26,0.8416955017301038,0.0009837680094112859
1462,32,12,20,0.40046838407494145,0.0004625723565071828
1463,3,1,2,1.0,0.0001086518220022215
1464,30,19,11,0.284366576819407,0.0010053729260661294
1465,119,66,53,0.3098309608540925,0.00247053050804733
1466,99,67,32,0.265658747300216,0.00260059137802587
1467,127,82,45,0.22868066355624675,0.0032445596272006063
1468,47,27,20,0.2934560327198364,0.0010801218493671938
1469,14,1,13,0.6055555555555555,0.00010391912596127148
1470,17,10,7,0.23282442748091603,0.0006894058958863488
1471,40,18,22,0.5749674054758801,0.000502724421960245
1472,32,13,19,0.6983471074380165,0.0004716097111056097
1473,1,0,1,0.0,6.45240993381665e-05
1474,20,6,14,0.33666666666666667,0.0004514827611592029
1475,45,23,22,0.6529774127310062,0.0007775005805531842
1476,81,42,39,0.4386051080550098,0.0016237652486707178
1477,21,4,17,0.5509708737864077,0.0002531873611263922
1478,75,46,29,0.4716039907904835,0.0018609104824202493
1479,20,10,10,0.7727272727272727,0.0002718685333990008
1480,40,22,18,0.38472622478386165,0.0006752835247617197
1481,19,10,9,0.3231707317073171,0.0008681838824768812
1482,10,3,7,0.27380952380952384,0.0002041292098227205
1483,1,0,1,0.0,6.45240993381665e-05
1484,12,9,3,0.18461538461538463,0.00039554471416481876
1485,5,1,4,0.16666666666666666,8.193652845627633e-05
1486,1,0,1,0.0,6.45240993381665e-05
1487,13,6,7,0.8,0.00023277242640625196
1488,14,5,9,0.4883720930232558,0.00021264073368974925
1489,9,4,5,0.23684210526315788,0.0002115220774642506
1490,6,3,3,0.4230769230769231,0.0001820647475694392
1491,7,2,5,0.15,0.00026982600048713667
1492,25,16,9,0.3150684931506849,0.0007130516589500416
1493,30,17,13,0.19864864864864865,0.0009822651991314697
1494,2,0,2,0.0,6.45240993381665e-05
1495,8,4,4,0.11538461538461539,0.00020975573613638275
1496,5,0,5,0.0,6.45240993381665e-05
1497,14,11,3,0.2265625,0.0033720144378715164
1498,31,23,8,0.06359102244389027,0.0028619676895227215
1499,3,1,2,0.0,0.0001122234006173161
1500,10,5,5,1.0,0.00019888223389421514
1501,8,2,6,0.14285714285714285,0.00012542102599958065
1502,7,4,3,0.6666666666666666,0.0004068910221829136
1503,8,4,4,1.0,0.00017372860671207045
1504,22,12,10,0.27111111111111114,0.0005298349721527499
1505,25,13,12,0.23711340206185566,0.0007174067170918707
1506,10,5,5,1.0,0.00019888223389421514
1507,4,1,3,0.4,0.0001530373833686413
1508,7,1,6,0.2857142857142857,9.372272485411232e-05
1509,40,27,13,0.07604017216642754,0.0024538504553454597
1510,5,2,3,0.5,0.00011538454565703805
1511,1,0,1,0.0,6.45240993381665e-05
1512,4,2,2,0.6,0.00013652662268556114
1513,4,1,3,0.2,8.421507099478006e-05
1514,4,2,2,0.0,0.0002663275186576355
1515,21,7,14,0.43349753694581283,0.00047974522815652396
1516,2,0,2,0.0,6.45240993381665e-05
1517,12,5,7,0.125,0.0004316818428444098
1518,2,1,1,0.0,0.0004291135815339865
1519,4,1,3,0.0,9.003564603751244e-05
1520,3,1,2,0.0,0.0001122234006173161
1521,9,3,6,0.12857142857142856,0.000228348665101166
1522,6,1,5,0.0,7.77406846476358e-05
1523,12,9,3,0.056818181818181816,0.0006155814489993722
1524,2,1,1,0.0,0.0004291135815339865
1525,84,62,22,0.059383499546690845,0.0029165014226620505
1526,5,0,5,0.1,6.45240993381665e-05
1527,31,17,14,0.1571072319201995,0.0009152539806722223
1528,10,4,6,0.6097560975609756,0.0001845212632919202
1529,4,1,3,0.1,0.00012670962981322818
1530,17,10,7,0.0891089108910891,0.0007136928857696727
1531,2,0,2,0.5,6.45240993381665e-05
1532,13,6,7,0.5684931506849316,0.00023993975167343389
1533,10,4,6,0.6219512195121951,0.00018452126329192024
1534,2,0,2,1.0,6.45240993381665e-05
1535,9,4,5,0.05714285714285714,0.00029378472965527793
1536,3,0,3,0.5,6.45240993381665e-05
1537,9,4,5,0.75,0.0001800471022759026
1538,10,4,6,0.5853658536585366,0.00018452126329192024
1539,14,6,8,0.49411764705882355,0.00032030372092587886
1540,55,29,26,0.1436950146627566,0.0011853984133346335
1541,5,2,3,0.625,0.0005299513904812748
1542,8,0,8,0.23214285714285715,6.45240993381665e-05
1543,4,2,2,0.0,0.00014402293480341583
1544,14,7,7,0.3442622950819672,0.0006712825030912712
1545,23,12,11,0.8084577114427861,0.00037297527510050574
1546,5,3,2,0.2777777777777778,0.00017551776327485796
1547,10,4,6,0.14285714285714285,0.0004656502104540294
1548,8,4,4,0.038461538461538464,0.0002721262085048933
1549,15,7,8,0.07692307692307693,0.0002671203894782166
1550,3,1,2,0.5,0.000114454984211666
1551,11,7,4,0.32857142857142857,0.0005222868527365678
1552,9,2,7,0.19047619047619047,0.0001057466321702615
1553,2,1,1,0.0,0.0001754294479940466
1554,4,3,1,0.75,0.00014303588491909808
1555,22,14,8,0.3233695652173913,0.0013655418913812894
1556,2,0,2,0.0,6.45240993381665e-05
1557,2,0,2,0.0,6.45240993381665e-05
1558,9,4,5,0.6875,0.000519969485713023
1559,15,8,7,0.3783783783783784,0.0008814104698419642
1560,2,1,1,0.0,0.0004291135815339865
1561,4,2,2,0.0,0.0002345172966321147
1562,3,1,2,0.3333333333333333,9.194802814626324e-05
1563,2,0,2,0.5,6.45240993381665e-05
1564,3,1,2,0.0,0.00016445859401833962
1565,28,15,13,0.28662420382165604,0.0017933999459163717
1566,7,2,5,1.0,0.00017364405146034378
1567,8,4,4,0.36,0.0002460053433197579
1568,1,0,1,0.0,6.45240993381665e-05
1569,1,1,0,0.0,9.194802814626324e-05
1570,5,1,4,0.2777777777777778,0.00012042816425072826
1571,12,7,5,0.24444444444444444,0.00041990677083583543
1572,4,2,2,0.4166666666666667,9.745979698273215e-05
1573,47,42,5,0.03387259858442872,0.0018098924582854758
1574,11,7,4,0.05714285714285714,0.0002850926975396285
1575,14,5,9,0.3629032258064516,0.0004144256230690367
1576,5,4,1,0.2,0.00023731758287744693
1577,3,0,3,0.0,6.45240993381665e-05
1578,4,2,2,0.5,0.00013150591667542515
1579,1,0,1,0.0,6.45240993381665e-05
1580,15,8,7,0.5,0.0010143734195000198
1581,1,0,1,0.0,6.45240993381665e-05
1582,1,0,1,0.0,6.45240993381665e-05
1583,11,9,2,0.02857142857142857,0.0012395489187158027
1584,17,0,17,0.2610294117647059,6.45240993381665e-05
1585,14,7,7,0.5176470588235295,0.0006231672732053245
1586,1,0,1,0.0,6.45240993381665e-05
1587,22,16,6,0.08296943231441048,0.0007624460546709236
1588,5,2,3,0.2777777777777778,0.00014602515737878154
1589,5,1,4,0.0,8.193652845627633e-05
1590,4,1,3,0.5,9.003564603751244e-05
1591,6,2,4,0.0,0.0001067334007593401
1592,15,8,7,0.4166666666666667,0.0005037520302955974
1593,9,5,4,0.45,0.0002597425001838657
1594,6,3,3,0.2,0.00016472339122820112
1595,3,0,3,0.16666666666666666,6.45240993381665e-05
1596,2,2,0,0.0,0.0001364430845231957
1597,14,8,6,0.3546511627906977,0.0006167795360287284
1598,18,10,8,0.029166666666666667,0.00045924540474057623
1599,7,1,6,0.5,7.517432005016391e-05
1600,11,6,5,0.56,0.0006366530730842137
1601,15,7,8,0.23,0.0002886168554329338
1602,7,3,4,0.21052631578947367,0.0001744994378387622
1603,8,4,4,0.8333333333333334,0.0004986349620578502
1604,13,4,9,0.11538461538461539,0.0001671925553293478
1605,3,1,2,0.0,0.0001122234006173161
1606,18,0,18,0.3954248366013072,6.45240993381665e-05
1607,29,18,11,0.39504373177842567,0.0009774512425700997
1608,20,0,20,0.3868421052631579,6.45240993381665e-05
1609,4,2,2,0.0,0.00011342957455032587
1610,5,2,3,0.0,0.0003260468081401274
1611,16,10,6,0.42045454545454547,0.0012811865851771376
1612,13,3,10,0.4675324675324675,8.816987998769455e-05
1613,1,0,1,0.0,6.45240993381665e-05
1614,3,1,2,0.16666666666666666,0.00010598792616715291
1615,37,23,14,0.2701543739279588,0.00202206058523091
1616,16,8,8,0.8584070796460177,0.000645769053642351
1617,18,8,10,0.827433628318584,0.00028019534382486524
1618,4,2,2,0.08333333333333333,0.00012891624529256352
1619,17,9,8,0.6212121212121212,0.000482584700670634
1620,2,0,2,1.0,6.45240993381665e-05
1621,67,47,20,0.2640640155189137,0.004059343897888038
1622,11,0,11,0.3090909090909091,6.45240993381665e-05
1623,10,0,10,0.43333333333333335,6.45240993381665e-05
1624,24,13,11,0.40148698884758366,0.0008649370165694998
1625,19,8,11,0.7751937984496124,0.00028019534382486524
1626,27,13,14,0.4809688581314879,0.0004523954778783085
1627,26,17,9,0.5962962962962963,0.0020232956972325664
1628,40,18,22,0.2926829268292683,0.0007141757370127148
1629,28,19,9,0.5377358490566038,0.002109536794981618
1630,26,14,12,0.4240506329113924,0.0011267984054732264
1631,20,10,10,0.5769230769230769,0.0007248408448694526
1632,14,6,8,0.4274193548387097,0.000322291253295625
1633,12,4,8,0.2857142857142857,0.0001520998504356049
1634,5,1,4,0.0,8.193652845627633e-05
1635,44,25,19,0.5722748815165877,0.002523485367227424
1636,45,26,19,0.4605411499436302,0.0028367346721439456
1637,75,47,28,0.2552702184745113,0.00501911976287995
1638,70,35,35,0.3016821602478973,0.002085512036471562
1639,28,14,14,0.4936102236421725,0.0004669284327118312
1640,19,9,10,0.6341463414634146,0.00070971503242452
1641,62,50,12,0.2075525269733106,0.0038731703085120948
1642,2,0,2,1.0,6.45240993381665e-05
1643,52,29,23,0.3851239669421488,0.001919126843099518
1644,12,6,6,0.34146341463414637,0.0006809675923722639
1645,65,44,21,0.26353790613718414,0.0026695270310107947
1646,62,37,25,0.31888191671420424,0.002183134372511967
1647,106,74,32,0.15044994375703036,0.0034484586812469683
1648,71,40,31,0.27522541863460714,0.002025798871341509
1649,14,5,9,0.47752808988764045,0.0001735505067399444
1650,5,3,2,0.0,0.0007610145888063089
1651,15,8,7,0.41414141414141414,0.0003318449956041471
1652,7,2,5,0.3888888888888889,0.0001134015729079582
1653,72,51,21,0.2281067556296914,0.004321476850727785
1654,56,39,17,0.3429781227946366,0.0036876415173809855
1655,2,1,1,0.0,0.00038567617381568195
1656,5,0,5,0.05,6.45240993381665e-05
1657,13,0,13,0.5833333333333334,6.45240993381665e-05
1658,30,15,15,0.3091334894613583,0.0008300484703820384
1659,22,12,10,0.5315315315315315,0.0011449368299027633
1660,34,19,15,0.37679671457905545,0.0009093619457125646
1661,44,24,20,0.5889008620689655,0.0025839700811222588
1662,20,9,11,0.6263736263736264,0.00081470120272124
1663,37,10,27,0.386535552193646,0.0010310698099415003
1664,26,13,13,0.49250936329588013,0.0004191200050561478
1665,4,1,3,0.2,0.00011273499323118101
1666,21,10,11,0.7592592592592593,0.0003715046179995171
1667,4,0,4,0.16666666666666666,6.45240993381665e-05
1668,16,5,11,0.4,0.00035575343890626696
1669,10,3,7,0.32558139534883723,0.00013486388953211419
1670,9,2,7,0.225,9.687561993853823e-05
1671,2,1,1,0.0,0.00017212659044338102
1672,6,2,4,0.1,9.687561993853823e-05
1673,44,26,18,0.5633136094674556,0.0024945966542804254
1674,3,1,2,0.0,0.0001122234006173161
1675,4,2,2,0.6,0.00028834743758325787
1676,11,3,8,0.19230769230769232,0.00027903295623768113
1677,2,0,2,0.5,6.45240993381665e-05
1678,2,0,2,0.5,6.45240993381665e-05
1679,6,4,2,0.4,0.0004899233497860583
1680,3,0,3,0.0,6.45240993381665e-05
1681,17,0,17,0.29411764705882354,6.45240993381665e-05
1682,15,7,8,0.9285714285714286,0.00025332567796590807
1683,11,5,6,0.62,0.00022625710686302282
1684,48,36,12,0.3349731663685152,0.0031524113303341796
1685,52,26,26,0.3826219512195122,0.0015451109277120926
1686,23,12,11,0.5308641975308642,0.00041189653097361867
1687,8,4,4,0.32,0.000812992568691142
1688,10,1,9,0.29545454545454547,8.277907687174659e-05
1689,9,3,6,0.2878787878787879,0.00017291503620472893
1690,12,4,8,0.4642857142857143,0.00017190844251482382
1691,12,4,8,0.3951612903225806,0.00019123778607608218
1692,7,3,4,0.7777777777777778,0.00014718069555322177
1693,7,3,4,0.7777777777777778,0.0001471806955532218
1694,16,7,9,0.6238938053097345,0.0002544232343282248
1695,12,6,6,1.0,0.00021156542057554378
1696,9,2,7,0.2647058823529412,0.00013883611052407544
1697,10,5,5,0.4024390243902439,0.00021640120878553274
1698,14,6,8,0.7588235294117647,0.00021835785197211267
1699,11,4,7,0.16363636363636364,0.00015799977497805555
1700,8,3,5,0.76,0.00011958421608630564
1701,15,7,8,0.6938775510204082,0.000250740812136351
1702,15,7,8,0.673469387755102,0.000251700075545722
1703,12,6,6,0.5121951219512195,0.0002521810537044666
1704,8,1,7,0.5,7.344255600195866e-05
1705,1,1,0,0.0,8.751967822152424e-05
1706,8,4,4,0.52,0.0001976354053002032
1707,9,3,6,0.6060606060606061,0.00012255232407545612
1708,3,1,2,1.0,8.761697870359057e-05
1709,8,3,5,0.76,0.00011958421608630561
1710,9,3,6,0.6060606060606061,0.0001225523240754561
1711,19,8,11,0.5030487804878049,0.00029657627992943445
1712,19,8,11,0.450920245398773,0.00029792172701478717
1713,5,2,3,0.3333333333333333,0.00010534257405712
1714,5,2,3,0.3333333333333333,9.942649006806129e-05
1715,10,1,9,0.5178571428571429,7.125395797641472e-05
1716,47,31,16,0.2619775739041794,0.0010748725965656492
1717,81,72,9,0.07110315652456882,0.0064358252341575805
1718,41,24,17,0.31893004115226337,0.001824281521831492
1719,6,1,5,0.08333333333333333,7.77406846476358e-05
1720,2,0,2,0.5,6.45240993381665e-05
1721,34,17,17,0.83298755186722,0.0003748248706267214
1722,50,44,6,0.03822222222222222,0.0034678188526871072
1723,4,2,2,0.0,0.00018766918941604357
1724,1,0,1,0.0,6.45240993381665e-05
1725,9,1,8,0.3333333333333333,7.219520658272641e-05
1726,12,3,9,0.4090909090909091,0.00019546153492861287
1727,10,7,3,0.43023255813953487,0.00021111726588545217
1728,2,0,2,1.0,6.45240993381665e-05
1729,1,0,1,0.0,6.45240993381665e-05
1730,10,5,5,0.38,0.00023293134431439226
1731,3,1,2,0.5,0.00010417891242226101
1732,51,25,26,0.40363007778738114,0.0010630727326116079
1733,30,15,15,0.9346793349168646,0.0003443557344883756
1734,4,0,4,0.5,6.45240993381665e-05
1735,4,1,3,0.7,0.00014206527846920188
1736,35,16,19,0.7112068965517241,0.00040564538090659614
1737,19,4,15,0.5505952380952381,0.00022124485569527744
1738,4,0,4,0.5,6.45240993381665e-05
1739,10,10,0,0.25555555555555554,0.0005475719422720828
1740,6,0,6,0.23333333333333334,6.45240993381665e-05
1741,1,0,1,0.0,6.45240993381665e-05
1742,9,3,6,0.2,0.0001950509047220765
1743,6,1,5,0.5,7.77406846476358e-05
1744,5,2,3,0.35,0.00015927471957752912
1745,36,22,14,0.36347197106690776,0.0007972952836695266
1746,19,14,5,0.0,0.0013244612265382349
1747,3,0,3,0.5,6.45240993381665e-05
1748,7,4,3,0.3,0.00023867993063382363
1749,16,8,8,0.5294117647058824,0.0004666955418209798
1750,5,2,3,0.25,0.00010385782554641888
1751,3,1,2,0.0,0.0001122234006173161
1752,13,3,10,0.3092105263157895,0.00012817561192090442
1753,15,6,9,0.2,0.0004351598785262247
1754,5,1,4,0.3888888888888889,0.0001017187013695292
1755,6,5,1,0.0,0.0003701283144791942
1756,5,3,2,1.0,0.0003695668085970508
1757,8,2,6,0.42857142857142855,9.003564603751244e-05
1758,9,4,5,0.2222222222222222,0.0003274304741896305
1759,5,0,5,0.3,6.45240993381665e-05
1760,7,4,3,0.15,0.00022431108522539216
1761,8,0,8,0.19642857142857142,6.45240993381665e-05
1762,1,0,1,0.0,6.45240993381665e-05
1763,6,1,5,0.4666666666666667,7.515605531832208e-05
1764,16,8,8,0.36046511627906974,0.00029943636639802687
1765,38,21,17,0.37338709677419357,0.0011395891180606505
1766,2,1,1,0.0,0.0004291135815339865
1767,20,13,7,0.17905405405405406,0.001746344040536532
1768,17,0,17,0.8492647058823529,6.45240993381665e-05
1769,4,1,3,0.3333333333333333,7.823606374221486e-05
1770,2,1,1,0.0,0.0002901087579121631
1771,10,5,5,0.7073170731707317,0.0002355867740172793
1772,11,5,6,0.2358490566037736,0.00016780071542197894
1773,23,10,13,0.35784313725490197,0.0005428858360089019
1774,5,4,1,0.0,0.00023651680995199893
1775,4,2,2,0.3333333333333333,0.00011023064735166107
1776,4,0,4,0.5833333333333334,6.45240993381665e-05
1777,4,1,3,0.0,9.003564603751244e-05
1778,1,0,1,0.0,6.45240993381665e-05
1779,30,15,15,0.9346793349168646,0.0003443557344883756
1780,7,2,5,0.1,9.822557659215948e-05
1781,33,15,18,0.77431906614786,0.0003474689356845645
1782,30,15,15,0.9346793349168646,0.0003443557344883756
1783,15,6,9,0.32432432432432434,0.000294635589390182
1784,15,11,4,0.22772277227722773,0.00045400228380768797
1785,14,7,7,0.26744186046511625,0.0002549662025419029
1786,10,2,8,0.125,9.373090105803174e-05
1787,13,1,12,0.4675324675324675,8.353912394257117e-05
1788,13,3,10,0.5754716981132075,0.00013810659808562533
1789,15,3,12,0.5592105263157895,0.00013905036423314754
1790,6,0,6,0.26666666666666666,6.45240993381665e-05
1791,10,2,8,0.5370370370370371,0.00014279179258845008
1792,10,1,9,0.7321428571428571,7.125395797641472e-05
1793,8,1,7,0.1,7.344255600195866e-05
1794,17,12,5,0.24019607843137256,0.0007873336089494348
1795,1,0,1,0.0,6.45240993381665e-05
1796,3,1,2,0.0,0.0001122234006173161
1797,13,7,6,0.25,0.0008079754115613535
1798,8,2,6,0.15384615384615385,0.00011724479915056359
1799,36,21,15,0.41621129326047357,0.000848661121377634
1800,10,4,6,0.4883720930232558,0.0001669164313387129
1801,4,1,3,0.16666666666666666,7.54936708614052e-05
1802,36,17,19,0.6617886178861788,0.00036923487297762034
1803,30,15,15,0.9346793349168646,0.0003443557344883756
1804,2,0,2,0.0,6.45240993381665e-05
1805,31,24,7,0.314214463840399,0.001970731496856287
1806,5,1,4,0.3333333333333333,8.193652845627633e-05
1807,11,6,5,0.2,0.000529868975129811
1808,1,0,1,0.0,6.45240993381665e-05
1809,3,1,2,0.5,8.600449862889154e-05
1810,3,1,2,0.0,0.0001122234006173161
1811,5,1,4,0.3333333333333333,8.11484478838801e-05
1812,30,15,15,0.9346793349168646,0.0003443557344883756
1813,15,7,8,0.34868421052631576,0.0002930040474499872
1814,4,3,1,0.5,0.0009622858404236687
1815,47,28,19,0.274077868852459,0.0013538892747151769
1816,9,4,5,0.47058823529411764,0.0002385004615502783
1817,8,2,6,0.32142857142857145,9.003564603751244e-05
1818,2,0,2,0.0,6.45240993381665e-05
1819,11,4,7,0.5288461538461539,0.0008292678332557962
1820,4,2,2,0.5,0.00013883611052407544
1821,3,1,2,0.6666666666666666,7.36654089408654e-05
1822,5,1,4,0.3333333333333333,0.00010107802889480029
1823,36,18,18,0.6750814332247557,0.0004154970189328868
1824,5,1,4,0.6666666666666666,8.193652845627633e-05
1825,18,8,10,0.1581196581196581,0.0009101903752214943
1826,14,7,7,0.45901639344262296,0.0003061689960647513
1827,2,0,2,0.0,6.45240993381665e-05
1828,9,2,7,0.425,9.60593346588801e-05
1829,33,21,12,0.40350877192982454,0.0008918366520911787
1830,2,1,1,0.0,8.669210980412928e-05
1831,28,11,17,0.1837837837837838,0.00039690752700070187
1832,46,37,9,0.06975505857294995,0.004609979493285287
1833,1,0,1,0.0,6.45240993381665e-05
1834,6,2,4,0.17857142857142858,0.0001099254206580168
1835,3,2,1,0.6666666666666666,0.00016222726779557318
1836,5,1,4,0.0,8.193652845627633e-05
1837,15,7,8,0.37623762376237624,0.0003091665786143803
1838,19,7,12,0.3393939393939394,0.0002350391518533265
1839,2,0,2,1.0,6.45240993381665e-05
1840,54,36,18,0.24275914634146342,0.002244051054571615
1841,7,3,4,0.6052631578947368,0.00012424588976313195
1842,7,3,4,0.6111111111111112,0.00015552428829629313
1843,10,4,6,0.04,0.0006741934952591605
1844,3,1,2,1.0,0.00023757332419892566
1845,4,1,3,0.0,9.003564603751244e-05
1846,30,15,15,0.9346793349168646,0.0003443557344883756
1847,14,5,9,0.16666666666666666,0.0005261150963225793
1848,15,11,4,0.22,0.0010921488457841047
1849,17,6,11,0.30597014925373134,0.0001749798266333119
1850,17,8,9,0.3787878787878788,0.0005396858937303057
1851,9,4,5,0.19117647058823528,0.00040595690856847936
1852,13,5,8,0.2635135135135135,0.00033315573383938283
1853,20,10,10,0.24172185430463577,0.0005611577999668877
1854,5,0,5,0.3,6.45240993381665e-05
1855,28,16,12,0.5110410094637224,0.0007844446196460407
1856,7,0,7,0.5714285714285714,6.45240993381665e-05
1857,12,3,9,0.3977272727272727,0.00012333135055068742
1858,2,1,1,0.0,0.00011431715222914789
1859,10,4,6,0.25,0.00022865109728980253
1860,24,15,9,0.14757709251101322,0.0009351699016210938
1861,5,2,3,0.5,0.00013958920565108006
1862,7,2,5,0.7777777777777778,0.00014459238880544116
1863,3,1,2,0.0,0.00017082261399722486
1864,3,1,2,0.0,0.00012085938106009335
1865,33,18,15,0.4616228070175439,0.0008197494311021503
1866,7,2,5,0.3,0.00013521187793043632
1867,2,1,1,0.0,0.0005568912920828553
1868,35,16,19,0.7811284046692607,0.0003639198971259872
1869,3,0,3,0.5,6.45240993381665e-05
1870,11,3,8,0.29411764705882354,0.0006426407450672654
1871,9,2,7,0.12857142857142856,0.0005106638553265548
1872,7,2,5,0.25,0.00010062143994459078
1873,31,15,16,0.876940133037694,0.0003455166213376827
1874,30,15,15,0.9346793349168646,0.0003443557344883756
1875,10,3,7,0.36904761904761907,0.00017113698024207567
1876,6,1,5,0.17857142857142858,9.395247923361975e-05
1877,6,2,4,0.3076923076923077,0.00025100223501252106
1878,9,6,3,0.27941176470588236,0.0003163518372336735
1879,7,1,6,0.05,0.0002901087579121631
1880,11,4,7,0.4215686274509804,0.00015655945158985093
1881,10,5,5,0.7073170731707317,0.0002355867740172793
1882,15,3,12,0.46601941747572817,0.0001502216968503821
1883,1,0,1,0.0,6.45240993381665e-05
1884,1,0,1,0.0,6.45240993381665e-05
1885,3,1,2,1.0,0.000132938193799018
1886,5,2,3,0.0,0.00016795993252836515
1887,10,2,8,0.3888888888888889,0.0001070023861229221
1888,2,1,1,0.5,7.823606374221486e-05
1889,2,1,1,0.0,0.0004291135815339865
1890,3,0,3,0.3333333333333333,6.45240993381665e-05
1891,15,8,7,0.40540540540540543,0.0002682657442830672
1892,1,0,1,0.0,6.45240993381665e-05
1893,7,4,3,0.34210526315789475,0.00014256647833231083
1894,1,0,1,0.0,6.45240993381665e-05
1895,9,2,7,0.25,0.0001436316382923055
1896,8,5,3,0.11538461538461539,0.0003455468002055619
1897,5,3,2,0.05,0.000136408646079816
1898,2,0,2,0.0,6.45240993381665e-05
1899,11,3,8,0.16981132075471697,0.00014886293492059487
1900,1,0,1,0.0,6.45240993381665e-05
1901,7,4,3,0.05,0.00018675883124200915
1902,2,1,1,0.0,0.00020034058195501567
1903,8,5,3,0.21428571428571427,0.0002173669483323492
1904,5,2,3,0.0,0.00022286514805066248
1905,5,2,3,0.5,0.00018345922536976717
1906,1,0,1,0.0,6.45240993381665e-05
1907,2,0,2,0.5,6.45240993381665e-05
1908,4,2,2,1.0,0.00016520213449081083
1909,5,2,3,0.0,0.00014132816280075408
1910,3,1,2,0.0,0.0001045736290649621
1911,4,2,2,0.0,0.00022286514805066248
1912,1,1,0,0.0,0.00015030991262825
1913,3,1,2,0.0,0.0002037430344512602
1914,4,2,2,0.0,0.000321881539208417
1915,2,0,2,0.0,6.45240993381665e-05
1916,1,0,1,0.0,6.45240993381665e-05
1917,3,0,3,0.3333333333333333,6.45240993381665e-05
1918,5,2,3,0.3333333333333333,0.00014655367113448068
1919,11,5,6,0.75,0.0002843623739111602
1920,5,2,3,0.5,0.0002782722799868328
1921,4,2,2,1.0,0.0002505408950272486
1922,13,7,6,0.76,0.0003463680241634141
1923,6,2,4,0.0,0.00020304187842924438
1924,2,1,1,0.0,0.00010769647028099528
1925,3,1,2,0.0,0.0001122234006173161
1926,6,3,3,0.0,0.00016561214450945926
1927,5,3,2,0.5,0.0006975877390746171
1928,8,3,5,0.56,0.00013546794466844317
1929,9,4,5,0.1875,0.00028653244219459625
1930,4,2,2,1.0,0.00017335040051265772
1931,8,4,4,0.3333333333333333,0.0003068351752724816
1932,6,2,4,0.34615384615384615,0.0002037924032585179
1933,3,1,2,0.0,0.0001122234006173161
1934,3,1,2,0.0,0.0001122234006173161
1935,4,1,3,0.2,0.00011336660450492782
1936,3,1,2,0.5,0.00011336660450492782
1937,4,2,2,1.0,0.0001787670031368912
1938,1,0,1,0.0,6.45240993381665e-05
1939,2,0,2,0.0,6.45240993381665e-05
1940,3,1,2,0.0,8.280671854356432e-05
1941,1,0,1,0.0,6.45240993381665e-05
1942,3,0,3,0.16666666666666666,6.45240993381665e-05
1943,3,0,3,0.16666666666666666,6.45240993381665e-05
1944,8,4,4,1.0,0.00023437476082458124
1945,2,1,1,0.0,0.0004291135815339865
1946,10,5,5,1.0,0.0002843623739111602
1947,11,5,6,0.78125,0.0002843623739111602
1948,11,5,6,0.78125,0.0002843623739111602
1949,2,0,2,1.0,6.45240993381665e-05
1950,10,5,5,1.0,0.00021404900694109444
1951,3,0,3,0.0,6.45240993381665e-05
1952,3,1,2,0.0,0.00010425188745159252
1953,13,5,8,0.5821917808219178,0.00022641638645833656
1954,11,5,6,0.8,0.00021937452664869136
1955,13,6,7,0.8,0.00025054700859452006
1956,12,5,7,0.6721311475409836,0.0002233437920601131
1957,10,5,5,1.0,0.0002140490069410944
1958,7,3,4,0.3333333333333333,0.00022835007472951635
1959,6,2,4,0.0,0.00013189271844082258
1960,12,6,6,0.6097560975609756,0.00018676344635577632
1961,4,2,2,1.0,0.0002505408950272486
1962,2,1,1,0.0,0.0004291135815339865
1963,2,1,1,0.0,0.0004291135815339865
1964,2,1,1,0.0,0.0002037430344512602
1965,6,2,4,0.46153846153846156,0.00012073921842232679
1966,6,2,4,0.0,0.00018258531050960948
1967,4,1,3,0.0,9.003564603751244e-05
1968,5,2,3,0.0,0.00013013337035031237
1969,4,1,3,0.0,0.0001014001100989494
1970,13,6,7,0.24509803921568626,0.0007318079556999028
1971,10,2,8,0.19767441860465115,0.0001951370504359967
1972,9,4,5,0.5526315789473685,0.00024164088379701487
1973,5,0,5,0.4,6.45240993381665e-05
1974,11,5,6,0.15714285714285714,0.00017427766521932822
1975,7,2,5,0.2222222222222222,0.0003028939784671788
1976,4,1,3,0.0,0.00010453824459903626
1977,3,1,2,0.0,9.414521699312006e-05
1978,16,4,12,0.6555555555555556,0.00013627801878152466
1979,20,5,15,0.4228187919463087,0.000183670576755634
1980,7,4,3,0.2222222222222222,0.00018710496299031545
1981,11,3,8,0.14705882352941177,0.0001993434732615722
1982,2,0,2,0.0,6.45240993381665e-05
1983,18,9,9,0.9861111111111112,0.0003300845266556428
1984,5,1,4,0.3333333333333333,8.193652845627633e-05
1985,3,0,3,0.5,6.45240993381665e-05
1986,7,2,5,0.3157894736842105,0.0001120412977811214
1987,5,2,3,0.0,0.00025178685882982593
1988,2,1,1,0.0,0.0001360029904692074
1989,3,1,2,0.0,0.0001122234006173161
1990,10,4,6,0.34523809523809523,0.00029855519773519556
1991,9,3,6,0.21052631578947367,0.00013109018431744636
1992,5,2,3,0.0,0.0001490143360721603
1993,5,2,3,0.625,0.00010214610735591212
1994,2,1,1,0.0,0.0004291135815339865
1995,40,22,18,0.29552023121387283,0.000758758861674063
1996,18,5,13,0.6637931034482759,0.00018605648393600746
1997,27,14,13,0.5120274914089347,0.0003699872468783027
1998,22,11,11,0.7472527472527473,0.0002809555188623269
1999,26,13,13,0.5390334572490706,0.0003317695173597035
2000,24,12,12,0.6272321428571429,0.00030043320506062014
2001,23,12,11,0.610655737704918,0.0003038676248340722
2002,26,11,15,0.5261194029850746,0.00029576836176750014
2003,25,11,14,0.5737704918032787,0.00030184780959961825
2004,17,8,9,1.0,0.00030630610856043024
2005,27,19,8,0.09628378378378379,0.0005666397260050545
2006,1,0,1,0.0,6.45240993381665e-05
2007,5,0,5,0.6,6.45240993381665e-05
2008,4,2,2,0.0,0.00016145956945852696
2009,3,1,2,0.0,0.00011667786147346867
2010,14,9,5,0.2698412698412698,0.00034420916176920095
2011,9,4,5,0.7777777777777778,0.0002456191355925754
2012,6,3,3,1.0,0.0001912711840603052
2013,27,15,12,0.5465517241379311,0.0005045126625548235
2014,24,12,12,0.6914414414414415,0.00040991363598163723
2015,27,14,13,0.5482758620689655,0.00047569211987056876
2016,26,11,15,0.5695488721804511,0.0004507373972906707
2017,6,2,4,0.1,0.00017847074255834727
2018,4,1,3,1.0,9.003564603751244e-05
2019,8,1,7,0.3,7.344255600195866e-05
2020,25,16,9,0.42338709677419356,0.0004038081046420499
2021,17,8,9,0.48,0.0003145293844289778
2022,14,6,8,0.6311475409836066,0.00019782070667968154
2023,20,9,11,0.4217687074829932,0.00025118159300961565
2024,2,0,2,0.0,6.45240993381665e-05
2025,14,7,7,0.20967741935483872,0.000341456434381205
2026,4,2,2,1.0,0.0001557643045312811
2027,8,4,4,0.4230769230769231,0.00023315916470734055
2028,9,2,7,0.325,0.00010829895758479748
2029,5,2,3,1.0,0.00014823528402564844
2030,21,11,10,0.41964285714285715,0.00029576836176750014
2031,1,0,1,0.0,6.45240993381665e-05
2032,1,0,1,0.0,6.45240993381665e-05
2033,24,11,13,0.7149321266968326,0.0003933322479775125
2034,5,2,3,0.3333333333333333,0.00014309670395001335
2035,12,3,9,0.2558139534883721,0.00011703182801789493
2036,9,3,6,0.3684210526315789,0.00011703182801789493
2037,7,3,4,0.75,0.00011703182801789493
2038,3,1,2,0.0,0.0001122234006173161
2039,2,1,1,0.0,0.0004291135815339865
2040,15,8,7,0.547945205479452,0.0004791917033580988
2041,10,5,5,1.0,0.0003540659510383145
2042,10,5,5,1.0,0.0003540659510383145
2043,10,5,5,1.0,0.00035406595103831454
2044,5,0,5,0.45,6.45240993381665e-05
2045,7,4,3,0.75,0.00021634233386261153
2046,22,16,6,0.11021505376344086,0.0008761244648724351
2047,5,3,2,0.0,0.0002749762201319445
2048,4,2,2,0.0,0.00014453914395723104
2049,31,25,6,0.06188118811881188,0.0013121209062971376
2050,2,0,2,0.0,6.45240993381665e-05
2051,12,4,8,0.38095238095238093,0.0002456191355925754
2052,5,2,3,0.0,0.0001490143360721603
2053,11,5,6,0.8,0.0003628751049704852
2054,4,2,2,0.0,0.00017847074255834727
2055,3,1,2,0.0,0.0001122234006173161
2056,2,0,2,0.5,6.45240993381665e-05
2057,17,7,10,0.23039215686274508,0.00030593863788177226
2058,8,2,6,0.06666666666666667,0.00010562780127447099
2059,2,1,1,0.0,0.0004291135815339865
2060,11,7,4,0.0,0.0003959764538867591
2061,4,2,2,0.0,0.0002597423161117526
2062,6,3,3,0.5,0.00021864713588003388
2063,6,2,4,0.5,0.0001572949544438082
2064,6,0,6,0.13333333333333333,6.45240993381665e-05
2065,18,9,9,0.1452991452991453,0.00038969099364967615
2066,20,16,4,0.13829787234042554,0.00076287559238262
2067,8,5,3,0.12962962962962962,0.00021796153840378013
2068,6,2,4,0.19230769230769232,0.0001868619732741861
2069,7,3,4,0.25,0.000137756418909698
2070,4,1,3,0.16666666666666666,0.0001037276957737528
2071,7,2,5,0.2777777777777778,0.000113038176552414
2072,12,6,6,1.0,0.0004144348771597194
2073,10,5,5,0.5192307692307693,0.00018371172544078752
2074,36,29,7,0.0763016157989228,0.0015564581592364347
2075,7,2,5,0.1111111111111111,0.00030678285772184994
2076,2,1,1,0.0,9.413726919701983e-05
2077,8,2,6,0.8571428571428571,9.976268305900017e-05
2078,3,1,2,0.0,9.881823667852408e-05
2079,3,0,3,0.3333333333333333,6.45240993381665e-05
2080,2,1,1,0.0,8.82478384382987e-05
2081,10,3,7,0.3333333333333333,0.00014133659866218928
2082,5,1,4,0.1111111111111111,0.00014569398673744052
2083,2,1,1,0.0,9.548810755725389e-05
2084,9,3,6,0.7368421052631579,0.00014748287249426655
2085,10,1,9,0.11363636363636363,9.915776153759149e-05
2086,5,2,3,0.5,0.0001602731477700289
2087,34,15,19,0.7650103519668737,0.00024994188050493616
2088,10,4,6,0.5576923076923077,0.00017005970887058836
2089,6,1,5,0.8333333333333334,7.77406846476358e-05
2090,12,3,9,0.4365079365079365,0.00011917766157775524
2091,7,2,5,0.6666666666666666,0.00011968696772211055
2092,11,5,6,0.16981132075471697,0.00021639330467275333
2093,13,5,8,0.5,0.0001630574271836487
2094,6,2,4,0.32142857142857145,0.00018179611645278315
2095,2,1,1,0.0,0.0004291135815339865
2096,21,9,12,0.8374233128834356,0.00024032418688001462
2097,16,6,10,0.40229885057471265,0.0002566545586126518
2098,22,14,8,0.12162162162162163,0.0013901625733220011
2099,5,1,4,0.0,8.193652845627633e-05
2100,19,5,14,0.3106060606060606,0.00019365655385759174
2101,19,12,7,0.09171597633136094,0.00035666115226603944
2102,5,3,2,0.2777777777777778,0.00016160452410077356
2103,5,1,4,0.6111111111111112,9.158403019353972e-05
2104,19,10,9,0.32196969696969696,0.000375072559214722
2105,6,2,4,0.1,0.00017847074255834727
2106,13,7,6,0.3618421052631579,0.0005663529012669297
2107,11,5,6,0.08571428571428572,0.000210245483735495
2108,5,2,3,0.0,0.00013060696233057706
2109,6,3,3,0.0,0.00016939653610420187
2110,5,2,3,0.16666666666666666,0.00014309670395001335
2111,5,2,3,0.16666666666666666,0.0001256346475971745
2112,10,7,3,0.2692307692307692,0.0004147011727896883
2113,8,4,4,0.038461538461538464,0.0002224876380636645
2114,4,1,3,1.0,9.003564603751244e-05
2115,5,3,2,0.5,0.0003820962501745917
2116,35,15,20,0.7504854368932039,0.00024994188050493616
2117,5,4,1,0.3333333333333333,0.0010821535881852765
2118,4,1,3,0.5,9.003564603751244e-05
2119,17,12,5,0.22277227722772278,0.000687553114936174
2120,4,2,2,0.0,0.0001570506399820045
2121,4,1,3,0.5,9.003564603751244e-05
2122,28,14,14,0.3663522012578616,0.0003991232869001185
2123,32,15,17,0.8554502369668247,0.00024994188050493616
2124,8,4,4,0.07692307692307693,0.0001629218278178187
2125,4,1,3,0.0,7.931451998068746e-05
2126,42,28,14,0.26788036410923277,0.00088073179279559
2127,29,18,11,0.32894736842105265,0.0005242878306647593
2128,17,0,17,0.7830882352941176,6.45240993381665e-05
2129,3,1,2,0.0,0.0001122234006173161
2130,9,4,5,0.3157894736842105,0.0003442602386336239
2131,5,2,3,1.0,0.0002458406198610772
2132,34,16,18,0.7619047619047619,0.0002718131631882634
2133,37,18,19,0.6554982817869416,0.00032412748518431136
2134,7,4,3,0.75,0.0003442602386336239
2135,15,9,6,0.13333333333333333,0.00032648461425916164
2136,22,12,10,0.5546448087431693,0.00037949315503621716
2137,2,1,1,0.0,0.0004291135815339865
2138,32,16,16,0.8293838862559242,0.00026315846581440543
2139,38,18,20,0.30762987012987014,0.0005536733302244611
2140,43,17,26,0.5720496894409938,0.0003271706604070582
2141,4,2,2,0.0,0.00017847074255834727
2142,41,17,24,0.5887207702888583,0.00027810938029328896
2143,34,16,18,0.7670807453416149,0.0002545125353062856
2144,4,2,2,1.0,0.00014309495567860333
2145,9,6,3,0.2631578947368421,0.0003412585838827741
2146,6,3,3,1.0,0.00020576269755081774
2147,13,7,6,0.3173076923076923,0.0008238092044246137
2148,66,49,17,0.13379930104842735,0.0012839850266762273
2149,4,0,4,0.25,6.45240993381665e-05
2150,11,5,6,0.2878787878787879,0.00027482439933081707
2151,16,5,11,0.375,0.00014802265070588738
2152,2,0,2,0.0,6.45240993381665e-05
2153,7,3,4,0.5,0.0002079817131118643
2154,1,1,0,0.0,0.00010881295171550889
2155,8,3,5,0.03333333333333333,0.00011896475499526515
2156,5,1,4,0.35,7.36654089408654e-05
2157,11,3,8,0.4411764705882353,0.00028937749538659807
2158,18,8,10,0.41379310344827586,0.0006707729711319887
2159,50,35,15,0.03524590163934426,0.0014413256427574376
2160,12,4,8,0.19047619047619047,0.000401629336213419
2161,4,1,3,1.0,9.003564603751244e-05
2162,12,4,8,0.4603174603174603,0.0001358800588623328
2163,9,3,6,0.35714285714285715,0.00010231371192707713
2164,3,3,0,1.0,0.00012231604167588976
2165,16,7,9,0.37209302325581395,0.0005301888924556132
2166,4,1,3,0.0,9.003564603751244e-05
2167,13,5,8,0.6372549019607843,0.00039085756474235107
2168,2,0,2,0.5,6.45240993381665e-05
2169,9,0,9,0.2916666666666667,6.45240993381665e-05
2170,20,8,12,0.6438356164383562,0.00020615202525596952
2171,3,0,3,0.6666666666666666,6.45240993381665e-05
2172,5,1,4,0.3888888888888889,7.579447690316994e-05
2173,3,1,2,0.0,0.0001122234006173161
2174,33,18,15,0.2071290944123314,0.0006130760283750352
2175,9,4,5,0.1388888888888889,0.00013653862183619838
2176,19,10,9,0.5546875,0.00035454048575050815
2177,6,0,6,0.13333333333333333,6.45240993381665e-05
2178,7,5,2,0.3,0.0009632664633970081
2179,6,1,5,0.4166666666666667,7.77406846476358e-05
2180,9,3,6,0.4142857142857143,0.0001049274970354471
2181,7,2,5,0.07894736842105263,0.0001513234753018125
2182,17,6,11,0.4153846153846154,0.00038838008581353175
2183,6,1,5,0.13333333333333333,7.914595348255756e-05
2184,6,0,6,0.16666666666666666,6.45240993381665e-05
2185,9,4,5,0.21052631578947367,0.00021922278200815854
2186,54,26,28,0.4160919540229885,0.0005626943933387752
2187,20,9,11,0.7586206896551724,0.00022783520106298667
2188,9,1,8,0.12857142857142856,7.121583038873328e-05
2189,14,4,10,0.46551724137931033,0.0001408753840834088
2190,12,0,12,0.25757575757575757,6.45240993381665e-05
2191,7,4,3,0.25,0.000336747812824782
2192,4,1,3,0.2,8.324906423798668e-05
2193,6,1,5,0.07142857142857142,0.0001395390401085276
2194,4,1,3,0.08333333333333333,0.0005176545657846163
2195,5,1,4,0.2222222222222222,8.811259358922874e-05
2196,10,5,5,1.0,0.00024399314750776595
2197,55,41,14,0.15036496350364964,0.0010346645717179464
2198,24,16,8,0.5602189781021898,0.0002735387254919395
2199,30,13,17,0.5653950953678474,0.00035410718460852247
2200,14,6,8,0.36470588235294116,0.00038298646360148065
2201,2,0,2,1.0,6.45240993381665e-05
2202,18,9,9,0.3547297297297297,0.00020234615436628026
2203,17,8,9,0.8571428571428571,0.00020893752176334913
2204,13,2,11,0.13815789473684212,0.0001227909613474921
2205,3,0,3,0.6666666666666666,6.45240993381665e-05
2206,29,14,15,0.8918575063613231,0.0002365043414668037
2207,11,5,6,0.8,0.00025006664366289974
2208,13,2,11,0.11038961038961038,8.658946196659929e-05
2209,11,5,6,0.64,0.00015855289481747
2210,6,0,6,0.26666666666666666,6.45240993381665e-05
2211,12,5,7,0.7073170731707317,0.00014972017285759323
2212,3,0,3,0.16666666666666666,6.45240993381665e-05
2213,30,14,16,0.8376777251184834,0.00023730168201608343
2214,6,1,5,0.03571428571428571,8.699770283837449e-05
2215,18,9,9,0.45614035087719296,0.00053480300261435
2216,11,2,9,0.26851851851851855,9.348258042121059e-05
2217,6,1,5,0.08333333333333333,7.77406846476358e-05
2218,30,13,17,0.26869158878504673,0.0009525477634413185
2219,10,1,9,0.21428571428571427,7.125395797641472e-05
2220,12,3,9,0.20454545454545456,0.00010991070066541486
2221,2,0,2,1.0,6.45240993381665e-05
2222,11,4,7,0.1792452830188679,0.00014517441809771295
2223,21,8,13,0.6158536585365854,0.00019303651483829388
2224,25,12,13,0.639344262295082,0.0003170413891782717
2225,5,1,4,0.8888888888888888,8.160778130616621e-05
2226,10,5,5,0.5365853658536586,0.00016926112291059889
2227,4,1,3,0.5,9.003564603751244e-05
2228,8,1,7,0.37037037037037035,7.495498734727421e-05
2229,7,3,4,0.2222222222222222,0.0004504345790291705
2230,21,9,12,0.6687116564417178,0.00022783520106298667
2231,38,18,20,0.6387987012987013,0.0004538947430071547
2232,13,1,12,0.3116883116883117,7.192143734262257e-05
2233,17,9,8,0.6060606060606061,0.0003542110842446388
2234,3,0,3,0.6666666666666666,6.45240993381665e-05
2235,5,1,4,1.0,0.00018186904851221798
2236,13,7,6,0.9027777777777778,0.00028691662249051553
2237,16,8,8,0.788235294117647,0.00032772797960494023
2238,14,7,7,0.234375,0.00024970899896663664
2239,13,6,7,0.8611111111111112,0.0002734368711673122
2240,36,16,20,0.6961678832116789,0.0002617247131162225
2241,13,6,7,0.8611111111111112,0.0002734368711673122
2242,9,3,6,0.38235294117647056,0.0001672772059037821
2243,16,7,9,0.6283185840707964,0.00029934092783356306
2244,10,5,5,0.36904761904761907,0.00019928410749684214
2245,6,2,4,0.10714285714285714,0.00016137214995843533
2246,9,3,6,0.45,0.0001382594093782102
2247,12,5,7,0.375,0.00014852910829333963
2248,7,1,6,0.14285714285714285,0.0001122677665328651
2249,13,5,8,0.5616438356164384,0.00025809777737889047
2250,7,2,5,0.2631578947368421,0.00011287231889748626
2251,6,1,5,0.08333333333333333,7.77406846476358e-05
2252,15,8,7,0.4266666666666667,0.0002923225600446846
2253,9,1,8,0.2857142857142857,7.491214555467682e-05
2254,11,5,6,0.24285714285714285,0.0005454519150092118
2255,8,4,4,0.5357142857142857,0.0001472456911470161
2256,1,0,1,0.0,6.45240993381665e-05
2257,7,2,5,0.3157894736842105,0.00011287231889748626
2258,2,0,2,0.0,6.45240993381665e-05
2259,13,7,6,0.23333333333333334,0.00046625861644974953
2260,4,1,3,0.5,9.003564603751244e-05
2261,5,0,5,0.3,6.45240993381665e-05
2262,1,0,1,0.0,6.45240993381665e-05
2263,8,4,4,0.6153846153846154,0.00015047329878498103
2264,17,8,9,0.5230769230769231,0.00019985105496935307
2265,19,8,11,0.6310975609756098,0.0002088870760740147
2266,21,8,13,0.6189024390243902,0.00019303651483829385
2267,8,4,4,0.16666666666666666,0.000149080905276851
2268,8,3,5,0.8461538461538461,0.00034443950572780397
2269,7,0,7,0.30952380952380953,6.45240993381665e-05
2270,35,19,16,0.2857142857142857,0.0005731356481197604
2271,1,0,1,0.0,6.45240993381665e-05
2272,12,5,7,0.3412698412698413,0.00017638372737876264
2273,17,10,7,0.11940298507462686,0.00040569285567662366
2274,4,2,2,0.4,9.481267537573662e-05
2275,7,3,4,0.2222222222222222,0.0001834957673092359
2276,15,4,11,0.44554455445544555,0.00013897485185997935
2277,3,0,3,0.16666666666666666,6.45240993381665e-05
2278,1,0,1,0.0,6.45240993381665e-05
2279,9,3,6,0.475,0.00014615870990731308
2280,11,5,6,0.74,0.00039228915158299804
2281,10,5,5,0.6,0.0004980530576501009
2282,5,2,3,0.625,0.00010290383343677273
2283,2,1,1,0.0,0.00021255726072400157
2284,5,1,4,0.0,8.692170226292334e-05
2285,7,1,6,0.375,7.362622437724382e-05
2286,10,5,5,1.0,0.00024399314750776598
2287,5,1,4,0.2777777777777778,9.432183208038399e-05
2288,68,61,7,0.06375525455394676,0.002796175082944083
2289,6,1,5,0.17857142857142858,7.615194158900547e-05
2290,9,2,7,0.125,0.00011093781393157998
2291,8,5,3,0.0,0.00028273402951172204
2292,22,9,13,0.7297297297297297,0.0002450477679058487
2293,32,13,19,0.4175257731958763,0.00041669296850333247
2294,21,9,12,0.7288557213930348,0.00024059476317889053
2295,20,10,10,0.8812154696132597,0.00025099315971937534
2296,40,22,18,0.28218465539661897,0.0005852053832086753
2297,26,12,14,0.6142857142857143,0.0003398126327588209
2298,15,4,11,0.2894736842105263,0.00014011744022784933
2299,9,2,7,0.15714285714285714,9.575318883522198e-05
2300,4,1,3,0.4,9.003564603751244e-05
2301,4,1,3,0.4,9.003564603751244e-05
2302,5,2,3,0.1111111111111111,0.00014003530215026173
2303,27,12,15,0.5425219941348973,0.00034071114668793773
2304,10,4,6,0.4166666666666667,0.00019078960394838747
2305,13,5,8,0.547945205479452,0.00015470298427425864
2306,2,2,0,1.0,9.348258042121059e-05
2307,9,4,5,0.9375,0.00033413734642618193
2308,4,2,2,0.08333333333333333,0.00011868490801185936
2309,2,2,0,0.5,0.0001256346475971745
2310,5,0,5,0.35,6.45240993381665e-05
2311,6,0,6,0.2,6.45240993381665e-05
2312,31,24,7,0.13478260869565217,0.0015981966123876157
2313,9,1,8,0.4142857142857143,6.961877723590347e-05
2314,15,7,8,0.345,0.00015971627405895341
2315,15,8,7,0.44666666666666666,0.0003667342443981537
2316,25,11,14,0.22154471544715448,0.00047774698410808227
2317,4,1,3,0.5,8.25309613367949e-05
2318,3,1,2,0.0,0.0001122234006173161
2319,4,2,2,0.0,0.0016170087606943424
2320,8,3,5,0.09615384615384616,0.00021727732137282564
2321,9,2,7,0.2,9.36081428662474e-05
2322,3,1,2,0.0,0.0020309741140995046
2323,7,1,6,0.15,0.00014065057689999867
2324,6,2,4,0.38461538461538464,0.00012181041593635937
2325,5,1,4,0.35,9.747392070259109e-05
2326,3,1,2,0.0,0.00010305056956268338
2327,5,0,5,0.55,6.45240993381665e-05
2328,4,1,3,0.0,9.003564603751244e-05
2329,7,0,7,0.42857142857142855,6.45240993381665e-05
2330,58,44,14,0.14239059438275636,0.001580558991571556
2331,6,1,5,0.08333333333333333,7.77406846476358e-05
2332,2,1,1,0.0,0.0004291135815339865
2333,7,3,4,0.625,0.00014770144657056563
2334,6,2,4,0.3076923076923077,0.00012181041593635937
2335,2,0,2,0.0,6.45240993381665e-05
2336,1,0,1,0.0,6.45240993381665e-05
2337,6,4,2,0.0,0.0008584872327758176
2338,5,1,4,0.0,8.193652845627633e-05
2339,2,1,1,0.0,0.00010149316901499454
2340,6,2,4,0.46153846153846156,0.00016820181198155639
2341,6,3,3,0.2,0.0001741343477527894
2342,5,2,3,0.0,0.00014037342101518878
2343,6,2,4,0.0,0.00013245160422134647
2344,9,6,3,0.3684210526315789,0.0009818817224042033
2345,1,0,1,0.0,6.45240993381665e-05
2346,2,1,1,0.0,0.0004291135815339865
2347,1,0,1,0.0,6.45240993381665e-05
2348,3,1,2,0.0,0.00016077755845475192
2349,8,4,4,0.038461538461538464,0.00018128769526165085
2350,2,1,1,0.0,0.0004291135815339865
2351,14,8,6,0.5919540229885057,0.0004212461659270611
2352,4,1,3,1.0,9.003564603751244e-05
2353,5,1,4,0.5555555555555556,0.00013799595101055586
2354,3,1,2,0.3333333333333333,0.00011122766185791527
2355,3,1,2,0.0,9.666049469051632e-05
2356,8,3,5,0.10714285714285714,0.0001984978477620504
2357,2,0,2,1.0,6.45240993381665e-05
2358,6,2,4,0.0,0.00010539363577963509
2359,6,5,1,0.16666666666666666,0.0015672993559517482
2360,4,1,3,0.0,9.190406863735224e-05
2361,3,1,2,0.5,9.414521699312006e-05
2362,5,1,4,0.0,8.193652845627633e-05
2363,5,1,4,0.05555555555555555,8.692170226292334e-05
2364,16,10,6,0.03333333333333333,0.00031847793053026087
2365,7,1,6,0.45,0.0002456367062103939
2366,4,1,3,0.2,0.00010453824459903626
2367,1,0,1,0.0,6.45240993381665e-05
2368,1,0,1,0.0,6.45240993381665e-05
2369,4,0,4,0.5,6.45240993381665e-05
2370,1,0,1,0.0,6.45240993381665e-05
2371,6,2,4,0.0,0.0001511063440511254
2372,2,0,2,0.5,6.45240993381665e-05
2373,7,4,3,0.0,0.00029007007120376426
2374,6,4,2,0.2,0.0004330579114096818
2375,4,1,3,1.0,9.003564603751244e-05
2376,9,1,8,0.2916666666666667,7.209120185321597e-05
2377,6,1,5,0.08333333333333333,7.77406846476358e-05
2378,1,0,1,0.0,6.45240993381665e-05
2379,4,2,2,0.0,0.00017847074255834727
2380,2,2,0,0.0,8.888628445421228e-05
2381,1,0,1,0.0,6.45240993381665e-05
2382,1,0,1,0.0,6.45240993381665e-05
2383,5,0,5,0.05,6.45240993381665e-05
2384,21,12,9,0.14201183431952663,0.0003722856997068497
2385,5,0,5,0.05,6.45240993381665e-05
2386,3,0,3,0.0,6.45240993381665e-05
2387,14,6,8,0.7777777777777778,0.0003298797675570624
2388,6,1,5,0.5,7.235950756905129e-05
2389,1,0,1,0.0,6.45240993381665e-05
2390,22,9,13,0.46216216216216216,0.00021343848390369761
2391,14,7,7,0.4666666666666667,0.0005322585491412154
2392,10,4,6,0.24074074074074073,0.000627614953264055
2393,20,11,9,0.32413793103448274,0.0011245948007337593
2394,8,4,4,0.0,0.00031899941172262446
2395,17,7,10,0.31,0.0009682297262755523
2396,6,3,3,1.0,0.00021850440756481356
2397,17,6,11,0.25742574257425743,0.0003556510733282798
2398,15,6,9,0.3972602739726027,0.0005272752844807427
2399,6,3,3,0.1,0.00020395213262541635
2400,10,5,5,1.0,0.00044289971796563493
2401,11,6,5,0.49074074074074076,0.0003396719919309166
2402,14,6,8,0.6588235294117647,0.00035929474248443095
2403,14,3,11,0.7272727272727273,9.330025549455642e-05
2404,36,25,11,0.11621621621621622,0.0013697893055829942
